bacru	x_{1} utters verbally/says/phonates/speaks [vocally makes sound] x_{2}.	- utter
badna	x_{1} is a banana/plantain [fruit/plant] of species/breed x_{2}.	- plantain; banana<br>- banana; fruit or plant
badri	x_{1} is sad/depressed/dejected/[unhappy/feels sorrow/grief] about x_{2} (abstraction).	- dejected<br>- sad<br>- depressed; sad
bajra	x_{1} runs on surface x_{2} using limbs x_{3} with gait x_{4}.	- run
bakfu	x_{1} is a bundle/package/cluster/clump/pack [shape/form] containing x_{2}, held together by x_{3}.	- bundle
bakni	x_{1} is a cow/cattle/kine/ox/[bull/steer/calf] [beef-producer/bovine] of species/breed x_{2}.	- bovine
bakri	x_{1} is a quantity of/contains/is made of chalk from source x_{2} in form x_{3}.	- chalk
baktu	x_{1} is a bucket/pail/can/deep, solid, wide-topped container of contents x_{2}, made of material x_{3}.	- bucket
balji	x_{1} is a bulb [body-part] of plant/species x_{2}; [metaphor: rounded, bulgy].	- bulb
balni	x_{1} is a balcony/overhang/ledge/shelf of building/structure x_{2}.	- balcony
balre	x_{1} is a blade of tool/weapon x_{2}.	- blade
balvi	x_{1} is in the future of/later than/after x_{2} in time sequence; x_{1} is latter; x_{2} is former.	- future; unspecified
bancu	x_{1} exceeds/is beyond limit/boundary x_{2} from x_{3} in property/amount x_{4} (ka/ni).	- is beyond
bandu	x_{1} (event) defends/protects x_{2} (object/state) from threat/peril/potential x_{3} (event).	- protect<br>- defend; non-agentive
banfi	x_{1} is an amphibian of species/breed x_{2}.	- amphibian
bangu	x_{1} is a/the language/dialect used by x_{2} to express/communicate x_{3} (si'o/du'u, not quote).	- language
banli	x_{1} is great/grand in property x_{2} (ka) by standard x_{3}.	- great
banro	x_{1} grows/expands [an increasing development] to size/into form x_{2} from x_{3}.	- grow
banxa	x_{1} is a bank owned by/in banking system x_{2} for banking function(s) x_{3} (event).	- bank
banzu	x_{1} (object) suffices/is enough/sufficient for purpose x_{2} under conditions x_{3}.	- sufficient; for purpose<br>- enough; for purpose<br>- suffice
bapli	x_{1} [force] (ka) forces/compels event x_{2} to occur; x_{1} determines property x_{2} to manifest.	- effective; having the power to produce effects<br>- force
barda	x_{1} is big/large in property/dimension(s) x_{2} (ka) as compared with standard/norm x_{3}.	- big<br>- large
bargu	x_{1} arches/curves over/around x_{2} and is made of x_{3}; x_{1} is an arch over/around x_{2} of material x_{3}.	- arch; shape
barja	x_{1} is a tavern/bar/pub serving x_{2} to audience/patrons x_{3}.	- bar; place
barna	x_{1}(s) is a/are mark(s)/spot(s) on x_{2} of material x_{3}.	- spot; patch on surface<br>- mark
bartu	x_{1} is on the outside of x_{2}; x_{1} is exterior to x_{2}.	- out
basna	x_{1} emphasizes/accentuates/gives emphasis/stress/accent to x_{2} by (action) x_{3}.	- emphasize
basti	x_{1} replaces/substitutes for/instead of x_{2} in circumstance x_{3}; x_{1} is a replacement/substitute.	- replace
batci	x_{1} bites/pinches x_{2} on/at specific locus x_{3} with x_{4}.	- bite
batke	x_{1} is a button/knob/[handle] on/for item x_{2}, with purpose x_{3}, made of material x_{4}.	- button; knob, handle
bavmi	x_{1} is a quantity of barley [grain] of species/strain x_{2}.	- barley
baxso	x_{1} reflects Malay-Indonesian common language/culture in aspect x_{2}.	- Malay-Indonesian
bebna	x_{1} is foolish/silly in event/action/property [folly] (ka) x_{2}; x_{1} is a boob.	- foolish
bemro	x_{1} reflects North American culture/nationality/geography in aspect x_{2}.	- North American
bende	x_{1} is a crew/team/gang/squad/band of persons x_{2} directed/led by x_{3} organized for purpose x_{4}.	- crew<br>- band; team<br>- club; association<br>- team; crew<br>- association; organization
bengo	x_{1} reflects Bengali/Bangladesh culture/nationality/language in aspect x_{2}.	- Bengali
benji	x_{1} transfers/sends/transmits x_{2} to receiver x_{3} from transmitter/origin x_{4} via means/medium x_{5}.	- send<br>- transmit<br>- transfer
bersa	x_{1} is a son of mother/father/parents x_{2} [not necessarily biological].	- son
berti	x_{1} is to the north/northern side [right-hand-rule pole] of x_{2} according to frame of reference x_{3}.	- north
besna	x_{1} is a/the brain [body-part] of x_{2}; [metaphor: intelligence, mental control].	- brain
betfu	x_{1} is a/the abdomen/belly/lower trunk [body-part] of x_{2}; [metaphor: midsection].	- abdomen
betri	x_{1} is a tragedy/disaster/tragic for x_{2}.	- tragedy
bevri	x_{1} carries/hauls/bears/transports cargo x_{2} to x_{3} from x_{4} over path x_{5}; x_{1} is a carrier/[porter].	- carry; transport
bidju	x_{1} is a bead/pebble [shape/form] of material x_{2}.	- bead
bifce	x_{1} is a bee/wasp/hornet of species/breed x_{2}.	- bee
bikla	x_{1} whips/lashes/snaps [a sudden violent motion].	- whip; violent sudden motion
bilga	x_{1} is bound/obliged to/has the duty to do/be x_{2} in/by standard/agreement x_{3}; x_{1} must do x_{2}.	- obliged<br>- must; obligation
bilma	x_{1} is ill/sick/diseased with symptoms x_{2} from disease x_{3}.	- ill
bilni	x_{1} is military/regimented/is strongly organized/prepared by system x_{2} for purpose x_{3}.	- military
bindo	x_{1} reflects Indonesian culture/nationality/language in aspect x_{2}.	- Indonesian
binra	x_{1} insures/indemnifies x_{2} (person) against peril x_{3} (event) providing benefit(s) x_{4} (event).	- insure
binxo	x_{1} becomes/changes/converts/transforms into x_{2} under conditions x_{3}.	- become
birje	x_{1} is made of/contains/is a amount of beer/ale/brew brewed from x_{2}.	- beer
birka	x_{1} is a/the arm [body-part] of x_{2}; [metaphor: branch with strength].	- arm; shoulder appendage
birti	x_{1} is certain/sure/positive/convinced that x_{2} is true.	- certain
bisli	x_{1} is a quantity of/is made of/contains ice [frozen crystal] of composition/material x_{2}.	- ice
bitmu	x_{1} is a wall/fence separating x_{2} and x_{3} (unordered) of/in structure x_{4}.	- wall
blabi	x_{1} is white/very-light colored [color adjective].	- white
blaci	x_{1} is a quantity of/is made of/contains glass of composition including x_{2}.	- glass
blanu	x_{1} is blue [color adjective].	- blue
bliku	x_{1} is a block [3-dimensional shape/form] of material x_{2}, surfaces/sides x_{3}.	- block
bloti	x_{1} is a boat/ship/vessel [vehicle] for carrying x_{2}, propelled by x_{3}.	- boat
bolci	x_{1} is a ball/sphere/orb/globe [shape/form] of material x_{2}; x_{1} is a spherical object [made of x_{2}].	- ball
bongu	x_{1} is a/the bone/ivory [body-part], performing function x_{2} in body of x_{3}; [metaphor: calcium].	- bone
botpi	x_{1} is a bottle/jar/urn/flask/closable container for x_{2}, made of material x_{3} with lid x_{4}.	- bottle
boxfo	x_{1} is a sheet/foil/blanket [2-dimensional shape/form flexible in 3 dimensions] of material x_{2}.	- sheet
boxna	x_{1} is a wave [periodic pattern] in medium x_{2}, wave-form x_{3}, wave-length x_{4}, frequency x_{5}.	- wave
bradi	x_{1} is an enemy/opponent/adversary/foe of x_{2} in struggle x_{3}.	- enemy
bratu	x_{1} is hail/sleet/freezing rain/solid precipitation of material/composition including x_{2}.	- hail
brazo	x_{1} reflects Brazilian culture/nationality/language in aspect x_{2}.	- Brazilian
bredi	x_{1} is ready/prepared for x_{2} (event).	- ready; prepared
bridi	x_{1} (du'u) is a predicate relationship with relation x_{2} among arguments (sequence/set) x_{3}.	- predicate
brife	x_{1} is a breeze/wind/gale from direction x_{2} with speed x_{3}; x_{1} blows from x_{2}.	- breeze<br>- wind; breeze
briju	x_{1} is an office/bureau/work-place of worker x_{2} at location x_{3}.	- office
brito	x_{1} reflects British/United Kingdom culture/nationality in aspect x_{2}.	- British
broda	1st assignable variable predicate (context determines place structure).	- predicate var 1
brode	2nd assignable variable predicate (context determines place structure).	- predicate var 2
brodi	3rd assignable variable predicate (context determines place structure).	- predicate var 3
brodo	4th assignable variable predicate (context determines place structure).	- predicate var 4
brodu	5th assignable variable predicate (context determines place structure).	- predicate var 5
bruna	x_{1} is brother of/fraternal to x_{2} by bond/tie/standard/parent(s) x_{3}; [not necess. biological].	- brother
budjo	x_{1} pertains to the Buddhist culture/religion/ethos in aspect x_{2}.	- Buddhist
bukpu	x_{1} is an amount of cloth/fabric of type/material x_{2}.	- cloth
bumru	x_{1} is foggy/misty/covered by a fog/mist/vapor of liquid x_{2}.	- fog
bunda	x_{1} is x_{2} (def. 1) local weight unit(s) [non-metric], standard x_{3}, subunits [e.g. ounces] x_{4}.	- pound
bunre	x_{1} is brown/tan [color adjective].	- brown
burcu	x_{1} is a brush for purpose x_{2} (event) with bristles x_{3}.	- brush; tool using bristles
burna	x_{1} is embarrassed/disconcerted/flustered/ill-at-ease about/under conditions x_{2} (abstraction).	- embarrassed
cabna	x_{1} is current at/in the present of/during/concurrent/simultaneous with x_{2} in time.	- current; present<br>- concurrent; simultaneous<br>- simultaneous<br>- now<br>- present; pertaining to the current time
cabra	x_{1} is apparatus/mechanism/device/equipment for function x_{2} controlled/[triggered] by x_{3} (agent).	- apparatus
cacra	x_{1} is x_{2} hours in duration (default is 1 hour) by standard x_{3}.	- hour
cadzu	x_{1} walks/strides/paces on surface x_{2} using limbs x_{3}.	- walk
cafne	x_{1} (event) often/frequently/commonly/customarily occurs/recurs by standard x_{2}.	- frequent; occurring often<br>- often
cakla	x_{1} is made of/contains/is a quantity of chocolate/cocoa.	- chocolate
calku	x_{1} is a shell/husk [hard, protective covering] around x_{2} composed of x_{3}.	- shell
canci	x_{1} vanishes/disappears from location x_{2}; x_{1} ceases to be observed at x_{2} using senses/sensor x_{3}.	- vanish
cando	x_{1} is idle/at rest/inactive.	- idle
cange	x_{1} is a farm/ranch at x_{2}, farmed by x_{3}, raising/producing x_{4}; (adjective:) x_{1} is agrarian.	- farm
canja	x_{1} exchanges/trades/barters commodity x_{2} for x_{3} with x_{4}; x_{1}, x_{4} is a trader/merchant/businessman.	- trade; give in exchange for<br>- exchange
canko	x_{1} is a window/portal/opening [portal] in wall/building/structure x_{2}.	- window
canlu	x_{1} is space/volume/region/room [at-least-3-dimensional area] occupied by x_{2}.	- space
canpa	x_{1} is a shovel/spade [bladed digging implement] for digging x_{2}.	- shovel
canre	x_{1} is a quantity of/contains/is made of sand/grit from source x_{2} of composition including x_{3}.	- sand
canti	x_{1} is a/the gut(s)/entrails/intestines/viscera/innards/digestive system [body-part] of x_{2}.	- gut<br>- intestines
carce	x_{1} is a cart/carriage/wagon [wheeled vehicle] for carrying x_{2}, propelled by x_{3}.	- cart
carmi	x_{1} is intense/bright/saturated/brilliant in property (ka) x_{2} as received/measured by observer x_{3}.	- intense
carna	x_1 turns about vector x_2 towards direction x_3, turning angular distance / to face point x_4	- turn; movement
cartu	x_{1} is a chart/diagram/map of/about x_{2} showing formation/data-points x_{3}.	- chart
carvi	x_{1} rains/showers/[precipitates] to x_{2} from x_{3}; x_{1} is precipitation [not limited to 'rain'].	- rain
casnu	x_{1}(s) (mass normally, but 1 individual/jo'u possible) discuss(es)/talk(s) about topic/subject x_{2}.	- converse; talk about<br>- discuss
catke	x_{1} [agent] shoves/pushes x_{2} at locus x_{3}.	- push; shove<br>- shove
catlu	x_{1} looks at/examines/views/inspects/regards/watches/gazes at x_{2}.	- look
catni	x_{1} has authority/is an official in/on/over matter/sphere/persons x_{2} derived on basis x_{3}.	- authority
catra	x_{1} (agent) kills/slaughters/murders x_{2} by action/method x_{3}.	- kill; agentive<br>- murder; kill
caxno	x_{1} is shallow in extent in direction/property x_{2} away from reference point x_{3} by standard x_{4}.	- shallow
cecla	x_{1} launches/fires/shoots projectile/missile x_{2}, propelled by x_{3} [propellant/propulsion].	- launcher
cecmu	x_{1} is a community/colony of organisms x_{2}.	- community
cedra	x_{1} is an era/epoch/age characterized by x_{2} (event/property/interval/idea).	- era
cenba	x_{1} varies/changes in property/quantity x_{2} (ka/ni) in amount/degree x_{3} under conditions x_{4}.	- vary
censa	x_{1} is holy/sacred to person/people/culture/religion/cult/group x_{2}.	- holy
centi	x_{1} is a hundredth [1/100; 10^{-2}] of x_{2} in dimension/aspect x_{3} (default is units).	- .01
cerda	x_{1} is an heir to/is to inherit x_{2} (object/quality) from x_{3} according to rule x_{4}.	- heir
cerni	x_{1} is a morning [dawn until after typical start-of-work for locale] of day x_{2} at location x_{3}.	- morning
certu	x_{1} is an expert/pro/has prowess in/is skilled at x_{2} (event/activity) by standard x_{3}.	- pro; expert<br>- expert<br>- skilled<br>- competent
cevni	x_{1} is a/the god/deity of people(s)/religion x_{2} with dominion over x_{3} [sphere]; x_{1} is divine.	- god
cfari	x_{1} [state/event/process] commences/initiates/starts/begins to occur; (intransitive verb).	- happen; occur<br>- initiate; non-agentive
cfika	x_{1} is a work of fiction about plot/theme/subject x_{2}/under convention x_{2} by author x_{3}.	- fiction
cfila	x_{1} (property - ka) is a flaw/fault/defect in x_{2} causing x_{3}.	- flaw
cfine	x_{1} is a wedge [shape/form/tool] of material x_{2}.	- wedge; shape or tool
cfipu	x_{1} (event/state) confuses/baffles x_{2} [observer] due to [confusing] property x_{3} (ka).	- confusing
ciblu	x_{1} is blood/vital fluid of organism x_{2}.	- blood
cicna	x_{1} is cyan/turquoise/greenish-blue [color adjective].	- cyan
cidja	x_{1} is food/feed/nutriment for x_{2}; x_{1} is edible/gives nutrition to x_{2}.	- food<br>- nutriment
cidni	x_{1} is a/the knee/elbow/knuckle [hinged joint, body-part] of limb x_{2} of body x_{3}.	- knee
cidro	x_{1} is a quantity of/contains/is made of hydrogen (H); [metaphor: light, flammable].	- hydrogen
cifnu	x_{1} is an infant/baby [helpless through youth/incomplete development] of species x_{2}.	- baby; infant<br>- infant
cigla	x_{1} is a/the gland [body-part] secreting x_{2}, of body x_{3}; x_{2} is a secretion of x_{1}.	- gland
cikna	(adjective:) x_{1} is awake/alert/conscious.	- awake
cikre	x_{1} repairs/mends/fixes x_{2} for use x_{3}.	- repair
ciksi	x_{1} (person) explains x_{2} (event/state/property) to x_{3} with explanation x_{4} (du'u).	- explain
cilce	(adjective:) x_{1} is wild/untamed.	- wild
cilmo	x_{1} is moist/wet/damp with liquid x_{2}.	- wet<br>- moist
cilre	x_{1} learns x_{2} (du'u) about subject x_{3} from source x_{4} (obj./event) by method x_{5} (event/process).	- learn
cilta	x_{1} is a thread/filament/wire [shape/form] of material x_{2}.	- thread
cimde	x_{1} (property - ka) is a dimension of space/object x_{2} according to rules/model x_{3}.	- dimension
cimni	x_{1} is infinite/unending/eternal in property/dimension x_{2}, to degree x_{3} (quantity)/of type x_{3}.	- infinite
cinba	x_{1} (agent) kisses/busses x_{2} at locus x_{3}.	- kiss
cindu	x_{1} is an oak, a type of tree of species/strain x_{2}.	- oak
cinfo	x_{1} is a lion/[lioness] of species/breed x_{2}.	- lion
cinje	x_{1} is a wrinkle/crease/fold [shape/form] in x_{2}.	- wrinkle
cinki	x_{1} is an insect/arthropod of species x_{2}; [bug/beetle].	- insect
cinla	x_{1} is thin in direction/dimension x_{2} by standard x_{3}; [relatively short in smallest dimension].	- thin
cinmo	x_{1} feels emotion x_{2} (ka) about x_{3}.	- feel; experience an emotion<br>- emotion; experienced
cinri	x_{1} (abstraction) interests/is interesting to x_{2}; x_{2} is interested in x_{1}.	- interesting
cinse	x_{1} in activity/state x_{2} exhibits sexuality/gender/sexual orientation x_{3} (ka) by standard x_{4}.	- sexual
cinta	x_{1} [material] is a paint of pigment/active substance x_{2}, in a base of x_{3}.	- paint; substance composed of solid coloring matter suspended in a liquid medium
cinza	x_{1} is a/are tong(s)/chopsticks/pincers/tweezers/pliers [tool/body-part] for x_{2} to pinch x_{3}.	- tweezers<br>- pliers<br>- tongs
cipni	x_{1} is a bird/avian/fowl of species x_{2}.	- bird
cipra	x_{1} (process/event) is a test for/proof of property/state x_{2} in subject x_{3} (individ./set/mass).	- test
cirko	x_{1} loses person/thing x_{2} at/near x_{3}; x_{1} loses property/feature x_{2} in conditions/situation x_{3}.	- lose
cirla	x_{1} is a quantity of/contains cheese/curd from source x_{2}.	- cheese
ciska	x_{1} inscribes/writes x_{2} on display/storage medium x_{3} with writing implement x_{4}; x_{1} is a scribe.	- write
cisma	x_{1} smiles/grins (facial expression).	- smile; expressing happiness through a facial expression
ciste	x_{1} (mass) is a system interrelated by structure x_{2} among components x_{3} (set) displaying x_{4} (ka).	- system
citka	x_{1} eats/ingests/consumes (transitive verb) x_{2}.	- eat
citno	x_{1} is young/youthful [relatively short in elapsed duration] by standard x_{2}.	- young
citri	x_{1} is a history of x_{2} according to x_{3} (person)/from point-of-view x_{3}.	- history
citsi	x_{1} is a season/is seasonal [cyclical interval], defined by interval/property x_{2}, of year(s) x_{3}.	- season
civla	x_{1} is a louse/flea [blood-sucking arthropod] of species/breed x_{2}, parasitic on x_{3}.	- louse
cizra	x_{1} is strange/weird/deviant/bizarre/odd to x_{2} in property x_{3} (ka).	- strange
ckabu	x_{1} is a quantity of/contains/is made of rubber/latex from source x_{2} of composition including x_{3}.	- rubber
ckafi	x_{1} is made of/contains/is a quantity of coffee from source/bean/grain x_{2}.	- coffee
ckaji	x_{1} has/is characterized by property/feature/trait/aspect/dimension x_{2} (ka); x_{2} is manifest in x_{1}.	- feature; trait<br>- trait<br>- has quality<br>- attribute; trait<br>- property; trait<br>- characteristic<br>- quality; trait
ckana	x_{1} is a bed/pallet of material x_{2} for holding/supporting x_{3} (person/object/event).	- bed
ckape	x_{1} is perilous/dangerous/potentially harmful to x_{2} under conditions x_{3}.	- peril
ckasu	x_{1} ridicules/mocks/scoffs at x_{2} about x_{3} (property/event) by doing activity x_{4} (event).	- ridicule
ckeji	x_{1} feels ashamed/mortified/humiliated under conditions x_{2} before community/audience x_{3}.	- ashamed
ckiku	x_{1} is a key fitting/releasing/opening/unlocking lock x_{2}, and having relevant properties x_{3}.	- key
ckilu	x_{1} (si'o) is a scale of units for measuring/observing/determining x_{2} (state).	- scale
ckini	x_{1} is related to/associated with/akin to x_{2} by relationship x_{3}.	- related
ckire	x_{1} is grateful/thankful to/appreciative of x_{2} for x_{3} (event/property).	- grateful
ckule	x_{1} is school/institute/academy at x_{2} teaching subject(s) x_{3} to audien./commun. x_{4} operated by x_{5}.	- school
ckunu	x_{1} is a conifer/pine/fir of species/strain x_{2} with cones x_{3}.	- conifer
cladu	x_{1} is loud/noisy at observation point x_{2} by standard x_{3}.	- loud
clani	x_{1} is long in dimension/direction x_{2} (default longest dimension) by measurement standard x_{3}.	- long
claxu	x_{1} is without/lacking/free of/lacks x_{2}; x_{1} is x_{2}-less.	- without<br>- lack
clika	x_{1} is a moss/lichen of species/strain x_{2} growing on x_{3}; (adjective:) x_{1} is mossy.	- mossy
clira	x_{1} (event) is early by standard x_{2}.	- early
clite	x_{1} is polite/courteous/civil in matter x_{2} according to standard/custom x_{3}.	- polite
cliva	x_{1} leaves/goes away/departs/parts/separates from x_{2} via route x_{3}.	- leave
clupa	x_{1} is a loop/circuit of x_{2} [material].	- loop
cmaci	x_{1} is a mathematics of type/describing x_{2}.	- mathematics
cmalu	x_{1} is small in property/dimension(s) x_{2} (ka) as compared with standard/norm x_{3}.	- small
cmana	x_{1} is a mountain/hill/mound/[rise]/[peak]/[summit]/[highlands] projecting from land mass x_{2}.	- mountain
cmavo	x_{1} is a structure word of grammatical class x_{2}, with meaning/function x_{3} in usage (language) x_{4}.	- structure word
cmene	x_{1} (quoted word(s)) is a/the name/title/tag of x_{2} to/used-by namer/name-user x_{3} (person).	- title; name<br>- name; reference word
cmila	x_{1} laughs (emotional expression).	- laugh
cmima	x_{1} is a member/element of set x_{2}; x_{1} belongs to group x_{2}; x_{1} is amid/among/amongst group x_{2}.	- belong to; be a member of<br>- member
cmoni	x_{1} utters moan/groan/howl/scream [non-linguistic utterance] x_{2} expressing x_{3} (property).	- moan
cnano	x_{1} [value] is a norm/average in property/amount x_{2} (ka/ni) among x_{3}(s) (set) by standard x_{4}.	- average; norm<br>- norm; average
cnebo	x_{1} is a/the neck [body-part] of x_{2}; [metaphor: a relatively narrow point].	- neck
cnemu	x_{1} (agent) rewards x_{2} [recipient] for atypical x_{3} (event/property) with reward/desserts x_{4}.	- reward
cnici	x_{1} is orderly/neat/ordered in property/quantity x_{2} (ka/ni).	- orderly
cnino	x_{1} is new/unfamiliar/novel to observer x_{2} in feature x_{3} (ka) by standard x_{4}; x_{1} is a novelty.	- new
cnisa	x_{1} is a quantity of/contains/is made of lead (Pb); [metaphor: heavy, malleable, soft metal].	- lead
cnita	x_{1} is directly/vertically beneath/below/under/underneath/down from x_{2} in frame of reference x_{3}.	- below<br>- beneath<br>- under; beneath
cokcu	x_{1} soaks up/absorbs/sucks up x_{2} from x_{3} into x_{4}; x_{1} is an absorbant.	- soak up
condi	x_{1} is deep in extent in direction/property x_{2} away from reference point x_{3} by standard x_{4}.	- deep
cortu	x_{1} hurts/feels pain/hurt at locus x_{2}.	- pain
cpacu	x_{1} gets/procures/acquires/obtains/accepts x_{2} from source x_{3} [previous possessor not implied].	- get
cpana	x_{1} is upon/atop/resting on/lying on [the upper surface of] x_{2} in frame of reference/gravity x_{3}.	- upon
cpare	x_{1} climbs/clambers/creeps/crawls on surface x_{2} in direction x_{3} using x_{4} [limbs/tools].	- climb
cpedu	x_{1} requests/asks/petitions/solicits for x_{2} of/from x_{3} in manner/form x_{4}.	- ask; make a request<br>- request
cpina	x_{1} is pungent/piquant/peppery/spicy/irritating to sense x_{2}.	- pungent
cradi	x_{1} broadcasts/transmits [using radio waves] x_{2} via station/frequency x_{3} to [radio] receiver x_{4}.	- radio
crane	x_{1} is anterior/ahead/forward/(in/on) the front of x_{2} which faces/in-frame-of-reference x_{3}.	- front; anterior
creka	x_{1} is a shirt/blouse/top [upper-body garment - not necessarily sleeved or buttoned], material x_{2}.	- shirt
crepu	x_{1} (agent) harvests/reaps/gathers crop/product/objects x_{2} from source/area x_{3}.	- harvest
cribe	x_{1} is a bear/ursoid of species/breed x_{2}.	- bear
crida	x_{1} is a fairy/elf/gnome/brownie/pixie/goblin/kobold [mythical humanoid] of mythos/religion x_{2}.	- elf; mythical creature<br>- goblin; mythical creature<br>- fairy<br>- demon<br>- gnome; mythical creature
crino	x_{1} is green/verdant [color adjective].	- green
cripu	x_{1} is a bridge/span over/across x_{2} between x_{3} and x_{4} [unordered, typically destination first].	- bridge
crisa	x_{1} is summer/summertime [hot season] of year x_{2} at location x_{3}.	- summer
critu	x_{1} is autumn/fall [harvest/cooling season] of year x_{2} at location x_{3}.	- autumn
ctaru	x_{1} is a tide [cyclical/periodic expansion] in x_{2} caused by x_{3}.	- tide
ctebi	x_{1} is a/the lip [body-part]/rim of orifice x_{2} of body x_{3}; (adjective:) x_{1} is labial.	- lip
cteki	x_{1} is a tax/levy/duty on goods/services/event x_{2} levied against x_{3} by authority/collector x_{4}.	- tax
ctile	x_{1} is a quantity of petroleum/oil from source x_{2}.	- oil; petroleum<br>- petroleum
ctino	x_{1} is a shadow/the shade of object x_{2}, made by light/energy source x_{3}.	- shadow
ctuca	x_{1} teaches audience x_{2} ideas/methods/lore x_{3} (du'u) about subject(s) x_{4} by method x_{5} (event).	- teach
cukla	x_{1} is round/circular [2-dimensional shape/form]; x_{1} is a disk/circle/ring.	- round; 2-dimensional
cukta	x_{1} is a book containing work x_{2} by author x_{3} for audience x_{4} preserved in medium x_{5}.	- book
culno	x_{1} is full/completely filled with x_{2}.	- full
cumki	x_{1} (event/state/property) is possible under conditions x_{2}; x_{1} may/might occur; x_{1} is a maybe.	- possible
cumla	x_{1} is humble/modest about x_{2} (abstraction); x_{1} displays humility about x_{2}.	- humble
cunmi	x_{1} is a quantity of millet [grain] of species/strain x_{2}.	- millet
cunso	x_{1} is random/fortuitous/unpredictable under conditions x_{2}, with probability distribution x_{3}.	- random
cuntu	x_{1} is an affair/organized activity involving person(s) x_{2} (ind./mass); x_{1} is x_{2}'s business.	- affair
cupra	x_{1} produces x_{2} [product] by process x_{3}.	- produce
curmi	x_{1} (agent) lets/permits/allows x_{2} (event) under conditions x_{3}; x_{1} grants privilege x_{2}.	- let<br>- permit
curnu	x_{1} is a worm/invertebrate animal of species/breed x_{2}.	- worm
curve	x_{1} is pure/unadulterated/unmitigated/simple in property x_{2} (ka).	- pure
cusku	x_{1} (agent) expresses/says x_{2} (sedu'u/text/lu'e concept) for audience x_{3} via expressive medium x_{4}.	- mention<br>- express<br>- say
cutci	x_{1} is a shoe/boot/sandal for covering/protecting [feet/hooves] x_{2}, and of material x_{3}.	- shoe
cutne	x_{1} is a/the chest/thorax/upper trunk/[rib cage/breast] [body-part] of x_{2}.	- chest; anatomy
cuxna	x_{1} chooses/selects x_{2} [choice] from set/sequence of alternatives x_{3} (complete set).	- pick; decide between options<br>- choose
dacru	x_{1} is a drawer/file in structure x_{2}, a [sliding compartment] container for contents x_{3}.	- drawer
dacti	x_{1} is a material object enduring in space-time; x_{1} is a thing.	- object
dadjo	x_{1} pertains to the Taoist culture/ethos/religion in aspect x_{2}.	- Taoist
dakfu	x_{1} is a knife (tool) for cutting x_{2}, with blade of material x_{3}.	- knife
dakli	x_{1} is a sack/bag with contents x_{2}, and of material x_{3}.	- bag; sack<br>- sack
damba	x_{1} fights/combats/struggles with x_{2} over issue x_{3} (abstract); x_{1} is a fighter/combatant.	- fight<br>- struggle; fight
damri	x_{1} is a drum/cymbal/gong [percussion musical instrument] with beater/actuator x_{2}.	- drum
dandu	x_{1} hangs/dangles/is suspended from x_{2} by/at/with joint x_{3}.	- hang
danfu	x_{1} is the answer/response/solution/[reply] to question/problem x_{2}.	- answer
danlu	x_{1} is an animal/creature of species x_{2}; x_{1} is biologically animate.	- animal
danmo	x_{1} is made of/contains/is a quantity of smoke/smog/air pollution from source x_{2}.	- smoke
danre	x_{1} (force) puts pressure on/presses/applies force to x_{2}.	- press; apply pressure<br>- pressure
dansu	x_{1} (individual, mass) dances to accompaniment/music/rhythm x_{2}.	- dance
danti	x_{1} is a ballistic projectile [e.g. bullet/missile] for firing by [gun/propelling launcher] x_{2}.	- projectile
daplu	x_{1} is an island/atoll/key of [material/properties] x_{2} in surroundings/body x_{3}; x_{1} is insular.	- island
dapma	x_{1} curses/damns/condemns x_{2} to fate (event) x_{3}.	- curse; fate
dargu	x_{1} is a road/highway to x_{2} from x_{3} with route x_{4} (x_{2}/x_{3} may be unordered).	- road
darlu	x_{1} argues for stand x_{2} against stand x_{3}; [an opponent is not necessary].	- argue
darno	x_{1} is far/distant from x_{2} in property x_{3} (ka).	- far
darsi	x_{1} shows audacity/chutzpah in behavior x_{2} (event/activity); x_{1} dares to do/be x_{2} (event/ka).	- audacity
darxi	x_{1} hits/strikes/[beats] x_{2} with instrument [or body-part] x_{3} at locus x_{4}.	- hit<br>- strike; hit
daski	x_{1} is a pocket/pouch of/in garment/item x_{2}.	- pocket
dasni	x_{1} wears/is robed/garbed in x_{2} as a garment of type x_{3}.	- wear
daspo	x_{1} (event) destroys/ruins/wrecks/despoils x_{2}; x_{1} is destructive.	- destroy
dasri	x_{1} is a ribbon/tape/strip/band/stripe of material x_{2}.	- ribbon
datka	x_{1} is a duck/[drake] of species/breed x_{2}.	- duck
datni	x_{1} (du'u) [fact/measurement] is data/information/statistic(s) about x_{2} gathered by method x_{3}.	- data
decti	x_{1} is a tenth [1/10; 10^{-1}] of x_{2} in dimension/aspect x_{3} (default is units).	- .1
degji	x_{1} is a/the finger/digit/toe [body-part] on limb/body site x_{2} of body x_{3}; [metaphor: peninsula].	- finger
dejni	x_{1} owes x_{2} in debt/obligation to creditor x_{3} in return for x_{4} [service, loan]; x_{1} is a debtor.	- owe
dekpu	x_{1} is x_{2} (default 1) local volume unit(s) [non-metric; e.g. bushel], standard x_{3}, x_{4} subunits.	- gallon
dekto	x_{1} is ten [10; 10^1] of x_{2} in dimension/aspect x_{3} (default is units).	- 10
delno	x_{1} is x_{2} candela [metric unit] in luminosity (default is 1) by standard x_{3}.	- candela
dembi	x_{1} is a bean/pea/leguminous seed from plant [legume] x_{2}.	- bean
denci	x_{1} is a/the tooth [body-part] of x_{2}; (adjective:) x_{1} is dental.	- tooth
denmi	x_{1} is dense/concentrated/packed/intense in property x_{2} (ka) at location/locus x_{3}.	- dense
denpa	x_{1} awaits/waits/pauses for/until x_{2} at state x_{3} before starting/continuing x_{4} (activity/process).	- wait; pause
dertu	x_{1} is a quantity of/contains/is made of dirt/soil/earth/ground from source x_{2} of composition x_{3}.	- dirt
derxi	x_{1} is a heap/pile/stack/mound/hill of materials x_{2} at location x_{3}.	- heap
desku	x_{1} shakes/quakes/trembles/quivers/shudders/wobbles/vibrates from force x_{2}.	- shake
detri	x_{1} is the date [day,{week},{month},year] of event/state x_{2}, at location x_{3}, by calendar x_{4}.	- date
dicra	x_{1} (event) interrupts/stops/halts/[disrupts] x_{2} (object/event/process) due to quality x_{3}.	- interrupt; to disrupt
dikca	x_{1} is electricity [electric charge or current] in/on x_{2} of polarity/quantity x_{3} (def. negative).	- electric
diklo	x_{1} is local to x_{2}; x_{1} is confined to locus x_{2} within range x_{3}; x_{1} is regional	- regional<br>- local
dikni	x_{1} is regular/cyclical/periodic in property (ka)/activity x_{2} with period/interval x_{3}.	- regular
dilcu	x_{1} is a quotient of 'x_{2}/x_{3}' [dividend x_{2} divided by divisor x_{3}], leaving remainder x_{4}.	- quotient
dilnu	x_{1} is a cloud/mass of clouds of material x_{2} in air mass x_{3} at floor/base elevation x_{4}.	- cloud
dimna	x_{1} is a fate/destiny of x_{2}; [doom, curse are mabla-forms]; x_{2} is fated/predestined/doomed to x_{1}.	- fate
dinju	x_{1} is a building/edifice for purpose x_{2}.	- building
dinko	x_{1} is a nail/tack [pointed driven/frictional fastener] of type/size x_{2} (ka), made of material x_{3}.	- nail
dirba	x_{1} is dear/precious/darling to x_{2}; x_{1} is emotionally valued by x_{2}.	- dear
dirce	x_{1} radiates/emits x_{2} under conditions x_{3}.	- radiate
dirgo	x_{1} is a drop [small, cohesive shape] of material [liquid/vapor] x_{2} in surrounding material x_{3}.	- drop
dizlo	x_{1} is low/down/downward in frame of reference x_{2} as compared with baseline/standard height x_{3}.	- low
djacu	x_{1} is made of/contains/is a quantity/expanse of water; (adjective:) x_{1} is aqueous/[aquatic].	- water
djedi	x_{1} is x_{2} full days in duration (default is 1 day) by standard x_{3}; (adjective:) x_{1} is diurnal.	- full day
djica	x_{1} desires/wants/wishes x_{2} (event/state) for purpose x_{3}.	- desire
djine	x_{1} is a ring/annulus/torus/circle [shape/form] of material x_{2}, inside diam. x_{3}, outside diam. x_{4}.	- ring
djuno	x_{1} knows fact(s) x_{2} (du'u) about subject x_{3} by epistemology x_{4}.	- know
donri	x_{1} is the daytime of day x_{2} at location x_{3}; (adjective:) x_{1} is diurnal (vs. nocturnal).	- daytime
dotco	x_{1} reflects German/Germanic culture/nationality/language in aspect x_{2}.	- German; in general
draci	x_{1} is a drama/play about x_{2} [plot/theme/subject] by dramatist x_{3} for audience x_{4} with actors x_{5}.	- drama
drani	x_{1} is correct/proper/right/perfect in property/aspect x_{2} (ka) in situation x_{3} by standard x_{4}.	- correct; right, proper
drata	x_{1} isn't the-same-thing-as/is different-from/other-than x_{2} by standard x_{3}; x_{1} is something else.	- other
drudi	x_{1} is a roof/top/ceiling/lid of x_{2}.	- roof
dugri	x_{1} is the logarithm of x_{2} with base x_{3}.	- logarithm; mathematical
dukse	x_{1} is an excess of/too much of x_{2} by standard x_{3}.	- excess
dukti	x_{1} is polar opposite from/contrary to x_{2} in property/on scale x_{3} (property/si'o).	- opposite
dunda	x_{1} [donor] gives/donates gift/present x_{2} to recipient/beneficiary x_{3} [without payment/exchange].	- give
dunja	x_{1} freezes/jells/solidifies at temperature x_{2} and pressure x_{3}.	- freeze
dunku	x_{1} is anguished/distressed/emotionally wrought/stressed by x_{2}.	- anguish
dunli	x_{1} is equal/congruent to/as much as x_{2} in property/dimension/quantity x_{3}.	- equal
dunra	x_{1} is winter/wintertime [cold season] of year x_{2} at location x_{3}.	- winter
dzena	x_{1} is an elder/ancestor of x_{2} by bond/tie/degree x_{3}; x_{1}'s generation precedes x_{2}'s parents.	- elder<br>- ancestor
dzipo	x_{1} reflects Antarctican culture/nationality/geography in aspect x_{2}.	- Antarctican
facki	x_{1} discovers/finds out x_{2} (du'u) about subject/object x_{3}; x_{1} finds (fi) x_{3} (object).	- discover
fadni	x_{1} [member] is ordinary/common/typical/usual in property x_{2} (ka) among members of x_{3} (set).	- ordinary
fagri	x_{1} is a fire/flame in fuel x_{2} burning-in/reacting-with oxidizer x_{3} (default air/oxygen).	- fire
falnu	x_{1} is a sail for gathering propelling material x_{2} on vehicle/motor x_{3}.	- sail
famti	x_{1} is an aunt/uncle of x_{2} by bond/tie x_{3}; x_{1} is an associated member of x_{2}'s parent's generation.	- aunt or uncle
fancu	x_{1} is a function/single-valued mapping from domain x_{2} to range x_{3} defined by expression/rule x_{4}.	- function; mathematical
fange	x_{1} is foreign/alien/[exotic]/unfamiliar to x_{2} in property x_{3} (ka).	- alien; foreign<br>- foreign; exotic
fanmo	x_{1} is an end/finish/termination of thing/process x_{2}; [not necessarily implying completeness].	- end
fanri	x_{1} is a factory/foundry/industrial plant/mill producing x_{2} from materials x_{3}.	- factory
fanta	x_{1} prevents/keeps/stops/restrains/constrains event x_{2} from occurring.	- prevent<br>- block; prevent from happening
fanva	x_{1} translates text/utterance x_{2} to language x_{3} from language x_{4} with translation result x_{5}.	- translate
fanza	x_{1} (event) annoys/irritates/bothers/distracts x_{2}.	- annoy
fapro	x_{1} opposes/balances/contends against opponent(s) x_{2} (person/force ind./mass) about x_{3} (abstract).	- oppose
farlu	x_{1} falls/drops to x_{2} from x_{3} in gravity well/frame of reference x_{4}.	- fall
farna	x_{1} is the direction of x_{2} (object/event) from origin/in frame of reference x_{3}.	- direction
farvi	x_{1} develops/evolves towards/into x_{2} from x_{3} through stages x_{4}.	- develop; to change progressively
fasnu	x_{1} (event) is an event that happens/occurs/takes place; x_{1} is an incident/happening/occurrence.	- event
fatci	x_{1} (du'u) is a fact/reality/truth/actuality, in the absolute.	- actual; factual, not just apparent or even false<br>- fact
fatne	x_{1} [sequence] is in reverse order from x_{2} [sequence]; x_{1} (object) is inverted from x_{2} (object).	- reverse
fatri	x_{1} is distributed/allotted/allocated/shared among x_{2} with shares/portions x_{3}; (x_{2}/x_{3} fa'u).	- distribute
febvi	x_{1} boils/evaporates at temperature x_{2} and pressure x_{3}.	- boil
femti	x_{1} is 10^{-15} of x_{2} in dimension/aspect x_{3} (default is units).	- 1E-15
fendi	x_{1} (agent) divides/partitions/separates x_{2} into sections/parts/ind. x_{3} by method/partition x_{4}.	- divide
fengu	x_{1} is angry/mad at x_{2} for x_{3} (action/state/property).	- angry
fenki	x_{1} (action/event) is crazy/insane/mad/frantic/in a frenzy (one sense) by standard x_{2}.	- crazy
fenra	x_{1} is a crack/fissure/pass/cleft/ravine/chasm/[defect/flaw] [shape/form] in x_{2}.	- crack
fenso	x_{1} sews/stitches/sutures materials x_{2} (ind./set) together with tool(s) x_{3}, using filament x_{4}.	- sew
fepni	x_{1} is measured in kopeck/cent money-subunits as x_{2} [quantity], in monetary system x_{3}.	- cent
fepri	x_{1} is a/the lung [body-part] of x_{2}; [metaphor: breathing/respiratory apparatus/bellows].	- lung
ferti	x_{1} is fertile/conducive for supporting the growth/development of x_{2}; x_{1} is fruitful/prolific.	- fertile
festi	x_{1}(s) is/are waste product(s) [left to waste] by x_{2} (event/activity).	- waste
fetsi	x_{1} is a female/doe of species x_{2} evidencing feminine trait(s) x_{3} (ka); x_{1} is feminine.	- female
figre	x_{1} is a fig [fruit/tree] of species/strain x_{2}.	- fig
filso	x_{1} reflects Palestinian culture/nationality in aspect x_{2}.	- Palestinian
finpe	x_{1} is a fish of species x_{2} [metaphorical extension to sharks, non-fish aquatic vertebrates].	- fish; living being
finti	x_{1} invents/creates/composes/authors x_{2} for function/purpose x_{3} from existing elements/ideas x_{4}.	- compose; invent<br>- invent
flalu	x_{1} is a law specifying x_{2} (state/event) for community x_{3} under conditions x_{4} by lawgiver(s) x_{5}.	- law
flani	x_{1} is a flute/pipe/fife/recorder [flute-like/air-reed musical instrument].	- flute
flecu	x_{1} is a current/flow/river of/in x_{2} flowing in direction to/towards x_{3} from direction/source x_{4}.	- flow
fliba	x_{1} fails at doing x_{2} (state/event); x_{1} is a failure at its role in x_{2}.	- fail
flira	x_{1} is a/the face [head/body-part] of x_{2}; (adjective:) x_{1} is facial.	- face
foldi	x_{1} is a field [shape/form] of material x_{2}; x_{1} is a broad uniform expanse of x_{2}.	- field
fonmo	x_{1} is a quantity of foam/froth/suds of material x_{2}, with bubbles/vacuoles of material x_{3}.	- foam
fonxa	x_{1} is a telephone transceiver/modem attached to system/network x_{2}.	- telephone; device
forca	x_{1} is a fork/fork-type tool/utensil for purpose x_{2} with tines/prongs x_{3} on base/support x_{4}.	- fork
fraso	x_{1} reflects French/Gallic culture/nationality/language in aspect x_{2}.	- French
frati	x_{1} reacts/responds/answers with action x_{2} to stimulus x_{3} under conditions x_{4}; x_{1} is responsive.	- react<br>- treat; handle, deal with or behave towards in a specific way
fraxu	x_{1} forgives x_{2} for event/state/activity x_{3}.	- forgive
frica	x_{1} differs/is distinct from/contrasts with/is unlike x_{2} in property/dimension/quantity x_{3}.	- differ
friko	x_{1} reflects African culture/nationality/geography in aspect x_{2}.	- African
frili	x_{1} (action) is easy/simple/facile for x_{2} (agent) under conditions x_{3}; x_{2} does x_{1} freely/easily.	- facile<br>- easy
frinu	x_{1} is a fraction, with numerator x_{2}, denominator x_{3} (x_{2}/x_{3}).	- fraction
friti	x_{1} offers/proffers x_{2} [offering] to x_{3} with conditions x_{4}.	- offer
frumu	x_{1} frowns/grimaces (facial expression).	- frown
fukpi	x_{1} is a copy/replica/duplicate/clone of x_{2} in form/medium x_{3} made by method x_{4} (event).	- copy
fulta	x_{1} (passive) floats on/in fluid (gas/liquid) x_{2}; x_{1} is buoyant.	- float
funca	x_{1} (event/property) is determined by the luck/fortune of x_{2}; (note mabla/zabna not implied).	- luck
fusra	x_{1} rots/decays/ferments with decay/fermentation agent x_{2}; x_{1} is rotten/decayed/fermented.	- rotten
fuzme	x_{1} is responsible/accountable for x_{2} (action/resulting state) to judge/authority x_{3}.	- responsible
gacri	x_{1} is a cover/[lid/top] for covering/concealing/sheltering x_{2}.	- cover; object
gadri	x_{1} is an article/descriptor labelling description x_{2} (text) in language x_{3} with semantics x_{4}.	- article
galfi	x_{1} (event) modifies/alters/changes/transforms/converts x_{2} into x_{3}.	- modify
galtu	x_{1} is high/up/upward in frame of reference x_{2} as compared with baseline/standard height x_{3}.	- high
galxe	x_{1} is a/the throat/gullet [body-part] of x_{2}; [metaphor: narrow(ing) opening of a deep hole].	- throat
ganlo	x_{1} (portal/passage/entrance-way) is closed/shut/not open, preventing passage/access to x_{2} by x_{3} (something being blocked).	- closed
ganra	x_{1} is broad/wide in dimension x_{2} [2nd most significant dimension] by standard x_{3}.	- broad<br>- wide; having a large physical extent from side to side
ganse	x_{1} [observer] senses/detects/notices stimulus x_{2} (object/nu) by means x_{3} under conditions x_{4}.	- sense<br>- feel; become aware of through the skin<br>- perceive; to detect something, not limited to vision
ganti	x_{1} is a/the testes/ovary/testicle/scrotum/balls/gonad/stamen/pistil [body-part] of x_{2}, gender x_{3}.	- gonad
ganxo	x_{1} is a/the anus/anal orifice/asshole/arsehole [body-part] of x_{2}; [metaphor: exit, waste exit].	- anus<br>- asshole; anus
ganzu	x_{1} organizes x_{2} [relative chaos] into x_{3} [ordered/organized result] by system/principle(s) x_{4}.	- arrange; organize<br>- organize
gapci	x_{1} is gaseous/fumes/a gas/vapor of material/composition including x_{2}, under conditions x_{3}.	- gas
gapru	x_{1} is directly/vertically above/upwards-from x_{2} in gravity/frame of reference x_{3}.	- above
garna	x_{1} is a rail/railing/bar [tool] supporting/restraining x_{2}, of material x_{3}.	- rail; tool<br>- railing; tool<br>- bar; tool
gasnu	x_{1} [person/agent] is an agentive cause of event x_{2}; x_{1} does/brings about x_{2}.	- do; bring about<br>- bring about
gasta	x_{1} is a quantity of/is made of/contains steel of composition including x_{2}.	- steel
genja	x_{1} is a root [body-part] of plant/species x_{2}; [metaphor: immobile, supporting, nourishing].	- root; plant appendage
gento	x_{1} reflects Argentinian culture/nationality in aspect x_{2}.	- Argentinian
genxu	x_{1} is a hook/crook [shape/form] of material x_{2}.	- hook
gerku	x_{1} is a dog/canine/[bitch] of species/breed x_{2}.	- dog; animal<br>- canine; animal<br>- bitch; female dog
gerna	x_{1} is the grammar/rules/defining form of language x_{2} for structure/text x_{3}.	- grammar
gidva	x_{1} (person/object/event) guides/conducts/pilots/leads x_{2} (active participants) in/at x_{3} (event).	- lead; guide<br>- guide<br>- conduct; guide
gigdo	x_{1} is a billion [British milliard] [10^9] of x_{2} in dimension/aspect x_{3} (default is units).	- 1E9
ginka	x_{1} is a camp/encampment/temporary residence of x_{2} at location x_{3}.	- camp
girzu	x_{1} is group/cluster/team showing common property (ka) x_{2} due to set x_{3} linked by relations x_{4}.	- group
gismu	x_{1} is a (Lojban) root word expressing relation x_{2} among argument roles x_{3}, with affix(es) x_{4}.	- root word
glare	x_{1} is hot/[warm] by standard x_{2}.	- hot
gleki	x_{1} is happy/merry/glad/gleeful about x_{2} (event/state).	- happy
gletu	x_{1} copulates/fucks/mates/has coitus/sexual intercourse with x_{2}.	- fuck; copulate<br>- have sex with<br>- copulate<br>- have sexual intercourse with
glico	x_{1} is English/pertains to English-speaking culture in aspect x_{2}.	- English; culture
gluta	x_{1} is a mitten/glove [hand and lower arm garment] of material x_{2}.	- glove
gocti	x_{1} is 10^{-24} of x_{2} in dimension/aspect x_{3} (default is units).	- 1E-24
gotro	x_{1} is 10^{24} of x_{2} in dimension/aspect x_{3} (default is units).	- 1E24
gradu	x_{1} [magnitude] is a unit/degree of/on scale/reference standard x_{2} (si'o) measuring property x_{3}.	- degree; unit<br>- unit
grake	x_{1} is x_{2} gram(s) [metric unit] in mass (default is 1) by standard x_{3}.	- gram
grana	x_{1} is a rod/pole/staff/stick/cane [shape/form] of material x_{2}.	- rod; shape/form<br>- cane; shape/form<br>- stick; shape/form<br>- staff; shape/form<br>- pole; shape/form
grasu	x_{1} is a quantity of/is made of/contains grease/fat/oil from source x_{2}.	- fat; grease<br>- grease
greku	x_{1} is a frame/structure/skeleton/outline supporting/load-bearing/determining the form of x_{2}.	- frame; structural basis
grusi	x_{1} is gray [color adjective].	- gray
grute	x_{1} is a fruit [body-part] of species x_{2}.	- fruit
gubni	x_{1} is public/un-hidden/open/jointly available to/owned by all among community x_{2} (mass).	- public
gugde	x_{1} is the country of peoples x_{2} with land/territory x_{3}; (people/territory relationship).	- country
gundi	x_{1} is industry/industrial/systematic manufacturing activity producing x_{2} by process/means x_{3}.	- industry
gunka	x_{1} [person] labors/works on/at x_{2} [activity] with goal/objective x_{3}.	- work
gunma	x_{1} is a mass/team/aggregate/whole, together composed of components x_{2}, considered jointly.	- mass; aggregate<br>- jointly; partially specified
gunro	x_{1} rolls/trundles on/against surface x_{2} rotating on axis/axle x_{3}; x_{1} is a roller.	- roll; of an object
gunse	x_{1} is a goose/[gander] of species/breed x_{2}.	- goose
gunta	x_{1} (person/mass) attacks/invades/commits aggression upon victim x_{2} with goal/objective x_{3}.	- attack
gurni	x_{1} is grain/[British: corn]/cereal from plant/species x_{2}.	- grain
guska	x_{1} blade/scraper/erosive scrapes/erodes/abrades x_{2} from x_{3}.	- scrape
gusni	x_1 [energy] is light/illumination illuminating x_2 from light source x_3.	- light; illumination<br>- illumine
gusta	x_{1} is a restaurant/cafe/diner serving type-of-food x_{2} to audience x_{3}.	- restaurant
gutci	x_{1} is x_{2} (default 1) short local distance unit(s) [non-metric], standard x_{3}, x_{4} subunits.	- cubit
gutra	x_{1} is a/the womb/uterus [body-part] of x_{2}; [metaphor: nourishing, protective, giving birth].	- womb
guzme	x_{1} is a melon/squash [fruit/plant] of species/strain x_{2}.	- melon
jabre	x_{1} brakes/causes to slow motion/activity x_{2} with device/mechanism/principle x_{3}.	- brake
jadni	x_{1} (object) adorns/decorates x_{2}; x_{1} is an adornment/decoration of x_{2}; x_{2} is fancy/decorated.	- adorn<br>- ornament
jakne	x_{1} is a rocket [vehicle] propelled by jet expelling x_{2} carrying payload x_{3}.	- rocket
jalge	x_{1} (action/event/state) is a result/outcome/conclusion of antecedent x_{2} (event/state/process).	- result
jalna	x_{1} is a quantity of/contains/is made of starch from source x_{2} of composition including x_{3}.	- starch
jalra	x_{1} is a cockroach/orthopteran/termite of order/species/breed x_{2}.	- termite<br>- cockroach
jamfu	x_{1} is a/the foot [body-part] of x_{2}; [metaphor: lowest portion] (adjective:) x_{1} is pedal.	- foot
jamna	x_{1} (person/mass) wars against x_{2} over territory/matter x_{3}; x_{1} is at war with x_{2}.	- war
janbe	x_{1} is a bell/chime/[tuning fork] [tuned percussion instrument] producing sound/note x_{2}.	- bell
janco	x_{1} is a/the shoulder/hip/joint [body-part] attaching limb/extremity x_{2} to body x_{3}.	- shoulder
janli	x_{1} collides with/crashes/bumps/runs into x_{2}.	- collide
jansu	x_{1} is a diplomat/consul representing polity x_{2} in/at negotiation x_{3} for function/purpose x_{4}.	- diplomat
janta	x_{1} is an account/bill/invoice for goods/services x_{2}, billed to x_{3} by x_{4}.	- account<br>- bill; invoice
jarbu	x_{1} is a suburban area of city/metropolis x_{2}.	- suburb
jarco	x_{1} (agent) shows/exhibits/displays/[reveals]/demonstrates x_{2} (property) to audience x_{3}.	- show; someone something
jarki	x_{1} is narrow in dimension x_{2} [2nd most significant dimension] by standard x_{3}.	- narrow
jaspu	x_{1} is a passport issued to x_{2} (person) by authority x_{3} allowing x_{4} (activity).	- passport<br>- account; registry to a service<br>- permit; artifact or document rendering something allowed or legal
jatna	x_{1} is captain/commander/leader/in-charge/boss of vehicle/domain x_{2}.	- captain
javni	x_{1} is a rule prescribing/mandating/requiring x_{2} (event/state) within system/community x_{3}.	- term; regulation<br>- rule
jbama	x_{1} is a bomb/explosive device with explosive material/principle x_{2}.	- bomb
jbari	x_{1} is a berry (fruit/plant) of plant/species x_{2}.	- berry
jbena	x_{1} is born to x_{2} at time x_{3} [birthday] and place x_{4} [birthplace]; x_{1} is native to (fo) x_{4}.	- born
jbera	x_{1} (agent) borrows/temporarily takes/assumes x_{2} (object) from source x_{3} for interval x_{4}.	- borrow
jbini	x_{1} is between/among set of points/bounds/limits x_{2} (set)/amidst mass x_{2} in property x_{3} (ka).	- between
jdari	x_{1} is firm/hard/resistant/unyielding to force x_{2} under conditions x_{3}.	- hard; resistant to pressure<br>- firm
jdice	x_{1} (person) decides/makes decision x_{2} (du'u) about matter x_{3} (event/state).	- decide
jdika	x_{1} (experiencer) decreases/contracts/is reduced/diminished in property/quantity x_{2} by amount x_{3}.	- decrease
jdima	x_{1} [amount] is the price of x_{2} to purchaser/consumer x_{3} set by vendor x_{4}.	- cost; amount of money<br>- price; sum of money
jdini	x_{1} is money/currency issued by x_{2}; (adjective:) x_{1} is financial/monetary/pecuniary/fiscal.	- money
jduli	x_{1} is a quantity of jelly/semisolid [texture] of material/composition including x_{2}.	- jelly
jecta	x_{1} is a polity/state governing territory/domain x_{2}; [government/territory relationship].	- polity
jeftu	x_{1} is x_{2} weeks in duration (default is 1 week) by standard x_{3}.	- week
jegvo	x_{1} pertains to the common Judeo-Christian-Moslem (Abrahamic) culture/religion/nationality in aspect x_{2}.	undefined
jelca	x_{1} burns/[ignites/is flammable/inflammable] at temperature x_{2} in atmosphere x_{3}.	- burn
jemna	x_{1} is a gem/polished stone/pearl of type x_{2} from gemstone/material/source x_{3}.	- gem
jenca	x_{1} (event) shocks/stuns x_{2}.	- shock
jendu	x_{1} is an axle/spindle [tool] on which x_{2} rotates, of material/properties x_{3}.	- axle
jenmi	x_{1} (mass) is an army serving group/community x_{2} (mass) in function x_{3} (activity).	- army
jerna	x_{1} (agent/person) earns/[deserves/merits] wages/salary/pay x_{2} for work/service x_{3} (activity).	- earn<br>- merit; deserve<br>- deserve; merit
jersi	x_{1} chases/pursues/(physically) follows after x_{2}; volition is not implied for x_{1} or x_{2}.	- follow; go/come after in physical space<br>- chase
jerxo	x_{1} reflects Algerian culture/nationality in aspect x_{2}.	- Algerian
jesni	x_{1} is a needle [pointed shape/form, not tool] of material x_{2}.	- needle; shape
jetce	x_{1} is a jet [expelled stream] of material x_{2} expelled from x_{3}.	- jet
jetnu	x_{1} (du'u) is true/truth by standard/epistemology/metaphysics x_{2}.	- true<br>- truth
jgalu	x_{1} is a/the claw/nail/talon [body-part] of x_{2}; [metaphor: pointed, penetrating, physical weapon].	- claw
jganu	x_{1} is an angle [2-dimensional shape/form] from vertex x_{2} subtended by lateral [segment] x_{3}.	- angle
jgari	x_{1} grasps/holds/clutches/seizes/grips/[hugs] x_{2} with x_{3} (part of x_{1}) at locus x_{4} (part of x_{2}).	- hold; grasp<br>- grasp
jgena	x_{1} is a knot/tangle in/between x_{2} (object/jo'u-objects).	- knot
jgina	x_{1} is a gene of creature [or locus on creature] x_{2} determining trait/process x_{3}.	- gene
jgira	x_{1} (person) feels/has pride in/about x_{2} (abstraction).	- pride
jgita	x_{1} is guitar/violin/fiddle/harp [stringed musical instrument] with actuator/plectrum/bow x_{2}.	- guitar
jibni	x_{1} is near/close to/approximates x_{2} in property/quantity x_{3} (ka/ni).	- near
jibri	x_{1} is a job/occupation/employment/vocation (a type of work regularly done for pay) of person x_{2}.	- job
jicla	x_{1} (object, or event: force) stirs/mixes/[roils/agitates] fluid (gas/liquid) x_{2}.	- stir
jicmu	x_{1} is a basis/foundation/underlying or fundamental principle of x_{2}; x_{1} is at the bottom of x_{2}.	- basic; foundational<br>- principle; basis<br>- basis
jijnu	x_{1} (person) intuits x_{2} (du'u) about subject x_{3}; [epistemology].	- intuit
jikca	x_{1} interacts/behaves socially with x_{2}; x_{1} socializes with/is sociable towards x_{2}.	- social; being extroverted/outgoing<br>- socialize
jikru	x_{1} is made of/contains/is a quantity of liquor/spirits distilled from x_{2}.	- liquor
jilka	x_{1} is a quantity of/contains/is made of alkali/base of composition including x_{2}.	- alkali
jilra	x_{1} (person) is jealous of/envies x_{2} (person) about/for x_{3} (property - ka).	- jealous
jimca	x_{1} is a branch/bough/limb of x_{2}; x_{2} forks into branches x_{1}; [preferred over metaphorical birka].	- branch
jimpe	x_{1} understands/comprehends fact/truth x_{2} (du'u) about subject x_{3}; x_{1} understands (fi) x_{3}.	- understand
jimte	x_{1} is a limit/extreme/bound/border/[confinement] of x_{2} in property/domain x_{3}.	- limit
jinci	x_{1} is a pair of shears/scissors for cutting x_{2}.	- shears
jinga	x_{1} (person/team) wins/gains prize x_{2} from/over x_{3} [competitors/losers] in competition x_{4}.	- win
jinku	x_{1} is a vaccine/immune-system stimulant protecting x_{2} against disease x_{3} introduced by method x_{4}.	- vaccine
jinme	x_{1} is a quantity of/contains/is made of made of metal of composition including x_{2}.	- metal
jinru	x_{1} (object/person) is immersed/submerged/bathes in liquid x_{2}.	- submerged<br>- immersed
jinsa	x_{1} (object) is clean/pure of material/contaminant/dirt x_{2} by standard x_{3}.	- clean
jinto	x_{1} is a well/spring of fluid x_{2} at location x_{3}.	- well; source of water or other fluid
jinvi	x_{1} thinks/opines x_{2} [opinion] (du'u) is true about subject/issue x_{3} on grounds x_{4}.	- opine
jinzi	x_{1} (property - ka) is an innate/inherent/intrinsic/natural property/quality/aspect of x_{2}.	- innate<br>- proper; intrinsic
jipci	x_{1} is a chicken/[hen/cock/rooster]/small fowl [a type of bird] of species/breed x_{2}.	- chicken
jipno	x_{1} is a tip/point/vertex/extremity/end [0-dimension shape/form] on object x_{2} at locus x_{3}.	- tip
jirna	x_{1} is a/the horn [body-part] of x_{2}; [metaphor: pointed extremity].	- horn; body part
jisra	x_{1} is made of/contains/is a quantity of juice/nectar from-source/of-type x_{2}.	- juice
jitfa	x_{1} (du'u) is false/is an untruth by standard/epistemology/metaphysics x_{2}.	- false
jitro	x_{1} has control over/harnesses/manages/directs/conducts x_{2} in x_{3} (activity/event/performance).	- control
jivbu	x_{1} weaves x_{2} from material/[yarn] x_{3}.	- weave
jivna	x_{1} competes/vies with opponent x_{2} in contest/competition x_{3} (event) for gain x_{4}; x_{1} rivals x_{2}.	- compete
jmaji	x_{1} (mass/jo'u) gathers/collects at location x_{2} from locations x_{3} (mass/jo'u).	- gather
jmifa	x_{1} is a shoal [shallow hazard]/reef of material x_{2} in body of water x_{3}.	- reef<br>- shoal
jmina	x_{1} adds/combines x_{2} to/with x_{3}, with result x_{4}; x_{1} augments x_{2} by amount x_{3}.	- add
jmive	x_{1} lives/is alive by standard x_{2}; x_{1} is an organism/living thing.	- live; being capable of vital functions
jordo	x_{1} reflects Jordanian culture/nationality in aspect x_{2}.	- Jordanian
jorne	x_{1} is joined to/connects to/is united with x_{2} at common locus x_{3}; x_{1} and x_{2} are a union.	- joined
jubme	x_{1} is a table/flat solid upper surface of material x_{2}, supported by legs/base/pedestal x_{3}.	- table
judri	x_{1} is an address of/are coordinates of x_{2} in system x_{3}.	- address; broadest sense
jufra	x_{1} (text) is a sentence/statement about x_{2} [topic/subject/predicate/focus] in language x_{3}.	- sentence; statement
jukni	x_{1} is a spider/arachnid/crustacean/crab/lobster/non-insect arthropod of species/breed x_{2}.	undefined
jukpa	x_{1} cooks/prepares food-for-eating x_{2} by recipe/method x_{3} (process).	- cook
julne	x_{1} is a net/filter allowing passage of x_{2}, prohibiting passage of x_{3}, netting properties x_{4}.	- net<br>- block; prevent from passing
jundi	x_{1} is attentive towards/attends/tends/pays attention to object/affair x_{2}.	- mind; pay attention to<br>- attentive<br>- follow; keep track of some event/person<br>- attend; pay attention to
jungo	x_{1} reflects Chinese [Mandarin, Cantonese, Wu, etc.] culture/nationality/language in aspect x_{2}.	- Chinese
junla	x_{1} is clock/watch/timer measuring time units x_{2} to precision x_{3} with timing mechanism/method x_{4}.	- clock
junri	x_{1} (person) is serious/earnest/has gravity about x_{2} (event/state/activity).	- serious
junta	x_{1} is the weight of object x_{2} in [gravitational or other force] field x_{3}.	- weight; any units
jurme	x_{1} is a bacterium/germ/microbe/protozoan/amoeba [1-celled life] of species/defining property x_{2}.	- germ<br>- microbe<br>- bacterium<br>- bacteria<br>- microorganism
jursa	x_{1} (event/action/state) is severe/harsh to x_{2} [victim/experiencer].	- severe
jutsi	x_{1} is a species of genus x_{2}, family x_{3}, etc.; [open-ended tree-structure categorization].	- species
juxre	x_{1} (action) is clumsy/awkward by standard x_{2}.	- clumsy
jvinu	x_{1} is the view/scene/panorama/sight/prospect of x_{2} (object/location) from point-of-view x_{3}.	- view; sight<br>- scene; landscape<br>- sight; view
kabri	x_{1} is a cup/glass/tumbler/mug/vessel/[bowl] containing contents x_{2}, and of material x_{3}.	- cup
kacma	x_{1} is a camera/photographic equipment recording illumination type x_{2} images to medium x_{3}.	- camera
kadno	x_{1} reflects Canadian culture/nationality in aspect x_{2}.	- Canadian
kafke	x_{1} coughs/farts/burps up/out x_{2} [predominantly gaseous] from orifice x_{3}.	- cough
kagni	x_{1} is a company/corporation/firm/partnership chartered by authority x_{2} for purpose x_{3}.	- company
kajde	x_{1} (event/experience) warns/cautions x_{2} (person) of/about danger x_{3} (event/state/property).	- warn
kajna	x_{1} is a shelf/counter/bar in/on/attached to supporting object x_{2}, for purpose x_{3}.	- shelf
kakne	x_{1} is able to do/be/capable of doing/being x_{2} (event/state) under conditions x_{3} (event/state).	- able
kakpa	x_{1} (agent) digs x_{2} [material] up/out of x_{3} [source/hole] with limbs/tool(s) x_{4}.	- dig
kalci	x_{1} is a/the feces/excrement/dung/shit of x_{2} (animal/person); (adjective:) x_{1} is fecal (matter).	- feces
kalri	x_{1} (portal/passage/entrance-way) is open/ajar/not shut permitting passage/access to x_{2} by x_{3}.	- open; ajar
kalsa	x_{1} is chaotic/disordered in property/aspect x_{2} (ka).	- chaotic
kalte	x_{1} hunts/stalks prey/quarry/game x_{2} for purpose x_{3}.	- hunt
kamju	x_{1} is a column/pillar of material x_{2}.	- column; pillar
kamni	x_{1} (mass) is a committee with task/purpose x_{2} of body x_{3}.	- committee
kampu	x_{1} (property - ka) is common/general/universal among members of set x_{2} (complete set).	- common; universal<br>- universal; among<br>- general; universal
kanba	x_{1} is a goat/angora/[billy-goat/kid] of species/breed x_{2}.	- goat
kancu	x_{1} (agent) counts the number in set x_{2} to be x_{3} [number/count] counting [off] by units x_{4}.	- count
kandi	x_{1} is dim/dull/pale/non-intense in property x_{2} (ka) as received/measured by observer x_{3}.	- dim
kanji	x_{1} calculates/reckons/computes x_{2} [value (ni)/state] from data x_{3} by process x_{4}.	- calculate
kanla	x_{1} is a/the eye [body-part] of x_{2}; [metaphor: sensory apparatus]; (adjective:) x_{1} is ocular.	- eye
kanro	x_{1} is healthy/fit/well/in good health by standard x_{2}.	- healthy<br>- well; in good health
kansa	x_{1} is with/accompanies/is a companion of x_{2}, in state/condition/enterprise x_{3} (event/state).	- with
kantu	x_{1} is a quantum/ray/elementary particle/smallest measurable increment of property/activity x_{2}.	- quantum
kanxe	x_{1} is a conjunction, stating that x_{2} (du'u) and x_{3} (du'u) are both true.	- conjunction
karbi	x_{1} [observer] compares x_{2} with x_{3} in property x_{4} (ka), determining comparison x_{5} (state).	- compare
karce	x_{1} is a car/automobile/truck/van [a wheeled motor vehicle] for carrying x_{2}, propelled by x_{3}	- automobile<br>- car
karda	x_{1} is a card [small nearly-2-dimensional shape/form] of material x_{2}, shape x_{3}.	- card
kargu	x_{1} (object/commodity/property/event) is costly/expensive/dear to x_{2} by standard x_{3}.	- costly
karli	x_{1} is a collar/ring/belt/band around/surrounding x_{2} made of material x_{3}.	- collar
karni	x_{1} is a journal/periodical/magazine/[newspaper] with content x_{2} published by x_{3} for audience x_{4}.	- journal<br>- press; media
katna	x_{1} (tool/blade/force) cuts [through]/splits/divides x_{2} (object) into pieces x_{3}.	- cut
kavbu	x_{1} captures/catches/apprehends/seizes/nabs x_{2} with trap/restraint x_{3}.	- capture<br>- catch; seize an object
kecti	x_{1} (person) pities/feels sorry for x_{2} (person) about x_{3} (abstraction).	- pity
kelci	x_{1} [agent] plays with plaything/toy x_{2}.	- play; with a toy or object
kelvo	x_{1} is x_{2} degree(s) Kelvin [metric unit] in temperature (default is 1) by standard x_{3}.	- kelvin
kenra	x_{1} is a cancer [malignant disease] in x_{2}.	- cancer
kensa	x_{1} is outer space near/associated with celestial body/region x_{2}.	- space; area beyond atmosphere of planets<br>- outer space
kerfa	x_{1} is a/the hair/fur [body-part] of x_{2} at body location x_{3}.	- hair
kerlo	x_{1} is a/the ear [body-part] of x_{2}; [metaphor: sensory apparatus, information gathering].	- ear
ketco	x_{1} reflects South American culture/nationality/geography in aspect x_{2}.	- South American
kevna	x_{1} is a cavity/hole/hollow/cavern in x_{2}; x_{1} is concave within x_{2}; x_{2} is hollow at locus x_{1}.	- cavity<br>- hole; cavity
kicne	x_{1} cushions x_{2} with material x_{3}; x_{1} is a cushion/pillow/pad [for x_{2}] of padding material x_{3}.	- cushion
kijno	x_{1} is a quantity of/contains/is made of oxygen (O); [metaphor: supporting life/combustion].	- oxygen
kilto	x_{1} is a thousand [1000; 10^3] of x_{2} in dimension/aspect x_{3} (default is units).	- 1000
kinli	x_{1} is sharp/keen at locus x_{2}.	- sharp
kisto	x_{1} reflects Pakistani/Pashto culture/nationality/language in aspect x_{2}.	- Pakistani
klaji	x_{1} is a street/avenue/lane/drive/cul-de-sac/way/alley/[road] at x_{2} accessing x_{3}.	- street
klaku	x_{1} weeps/cries tears x_{2} about/for reason x_{3} (event/state).	- cry; weep<br>- weep
klama	x_{1} comes/goes to destination x_{2} from origin x_{3} via route x_{4} using means/vehicle x_{5}.	- come
klani	x_{1} is a quantity quantified/measured/enumerated by x_{2} (quantifier) on scale x_{3} (si'o).	- level; degree or amount<br>- amount; a total of things<br>- quantity
klesi	x_{1} (mass/si'o) is a class/category/subgroup/subset within x_{2} with defining property x_{3} (ka).	- type; class<br>- subset; class<br>- subgroup; class<br>- class<br>- category; class
klina	x_{1} (object/medium) is clear/transparent/without obstacle to in-the-clear x_{2} [transmission].	- direct; straight/constant without interruption<br>- clear
kliru	x_{1} is a quantity of/contains/is made of halogen of type x_{2} [chlorine, fluorine, iodine, etc.].	- chlorine
kliti	x_{1} is a quantity of/contains/is made of clay [moist, clammy dirt] of composition including x_{2}.	- clay
klupe	x_{1} is a screw [fastener] for purpose x_{2}, threads [pitch, material] x_{3}, frame [size, material] x_{4}.	- screw
kluza	x_{1} (obj.) is loose/bloused/not tight on x_{2} (obj.) at locus x_{3}.	- loose
kobli	x_{1} is a quantity of cabbage/lettuce/leafy vegetable of species/strain x_{2}.	- cabbage
kojna	x_{1} is a corner/point/at-least-3-dimensional [solid] angle [shape/form] in/on x_{2}, of material x_{3}.	- corner
kolme	x_{1} is a quantity of/contains/is made of coal/peat/anthracite/bitumen from source x_{2}.	- coal
komcu	x_{1} is a comb [many-needled shape] of material x_{2} with tines/needles x_{3}.	- comb
konju	x_{1} is a cone [shape/form] of material x_{2} with vertex x_{3}.	- cone
korbi	x_{1} is an edge/margin/border/curb/boundary of x_{2} next-to/bordering-on x_{3}.	- edge
korcu	(adjective:) x_{1} is bent/crooked/not straight or direct/[twisted]/folded.	- crooked; bent<br>- bent; not straight
korka	x_{1} is a quantity of/contains/is made of cork/bark from tree/species x_{2}; [material].	- cork
kosta	x_{1} is a coat/jacket/sweater/cloak/[cape/shawl/pullover] [extra outer garment] of material x_{2}.	- jacket; garment worn on the upper body outside a shirt/blouse<br>- coat
kramu	x_{1} is x_{2} local area unit(s) [non-metric] (default 1) by standard x_{3}, x_{4} subunits.	- acre
krasi	x_{1} (site/event) is a source/start/beginning/origin of x_{2} (object/event/process).	- source<br>- origin; source
krati	x_{1} represents/is an agent/proxy/stands-in for [absent] x_{2} in matter(s)/function(s) x_{3}.	- represent
krefu	x_{1} (event) is the x_{3}'rd recurrence/repetition of x_{2} (abstract); x_{2} happens again in [form] x_{1}.	- recur
krici	x_{1} believes [regardless of evidence/proof] belief/creed x_{2} (du'u) is true/assumed about subject x_{3}.	- believe<br>- faith; to have faith
krili	x_{1} is a quantity of/contains/is made of crystal of composition x_{2} in form/arrangement x_{3}.	- crystal
krinu	x_{1} (event/state) is a reason/justification/explanation for/causing/permitting x_{2} (event/state).	- reason
krixa	x_{1} cries out/yells/howls sound x_{2}; x_{1} is a crier.	- cry out
kruca	x_{1} intersects/crosses/traverses x_{2} at locus x_{3}.	- cross; intersect<br>- intersect
kruji	x_{1} is made of/contains/is a quantity of cream/emulsion/puree [consistency] of composition x_{2}.	- cream
kruvi	x_{1} is a curve/turn/bend in x_{2}, at locus x_{3}, and defined by set of points/properties x_{4}.	- curve
kubli	x_{1} is a cube/regular polyhedron/polygon of dimensions x_{2} (def. 3), surfaces/sides x_{3} (def. 6).	- cube
kucli	x_{1} is curious/wonders about/is interested in/[inquisitive about] x_{2} (object/abstract).	- curious
kufra	x_{1} feels comfort/is comfortable with conditions/environmental property(ies) x_{2}.	- comfort
kukte	x_{1} is delicious/tasty/delightful to observer/sense x_{2} [person, or sensory activity].	- delicious
kulnu	x_{1} [mass of ideas, customs, skills, arts] is culture of nation/ethos x_{2} (mass); x_{1} is ethnic.	- culture
kumfa	x_{1} is a room of/in structure x_{2} surrounded by partitions/walls/ceiling/floor x_{3} (mass/jo'u).	- room
kumte	x_{1} is a camel/llama/alpaca/vicuna/dromedary of species/breed x_{2}.	- camel
kunra	x_{1} is/contains/is made from a mineral/ore of type/metal x_{2} mined from location/lode/mine x_{3}.	- mineral
kunti	x_{1} [container] is empty/vacant of x_{2} [material]; x_{1} is hollow.	- vacant; empty<br>- empty
kurfa	x_{1} is a right-angled shape/form defined by set of vertices x_{2}, dimensions x_{3} (default 2).	- square; four sided shape
kurji	x_{1} takes-care-of/looks after/attends to/provides for/is caretaker for x_{2} (object/event/person).	- take care of
kurki	x_{1} is bitter/acrid/sharply disagreeable to observer/sense x_{2}.	- bitter
kuspe	x_{1} ranges/extends/spans/persists/reaches across/over interval/gap/area/scope/extent/range x_{2}.	- range<br>- reach; touch by virtue of extent
kusru	x_{1} (person) is cruel/mean/unkind to victim x_{2}.	- cruel
labno	x_{1} is a wolf/lupine of species/breed x_{2}.	- wolf
lacpu	x_{1} pulls/tugs/draws/drags x_{2} by handle/at locus x_{3}.	- pull; to draw or tug at with force
lacri	x_{1} relies/depends/counts on/trusts x_{2} to bring about/ensure/maintain x_{3} (event/state).	- dependent; relying upon<br>- rely<br>- depend; rely
ladru	x_{1} is made of/contains/is a quantity of milk from source x_{2}; (adjective:) x_{1} is lactic/dairy.	- milk
lafti	x_{1} (force) lifts/applies raising/supporting force to x_{2} at locus x_{3} in gravity well x_{4}.	- lift
lakne	x_{1} (event/state/property) is probable/likely under conditions x_{2}.	- probable<br>- likely; probable
lakse	x_{1} is quantity of wax [substance especially soft/moldable when warm] from source x_{2}.	- wax
lalxu	x_{1} is a lake/lagoon/pool at site/within land mass x_{2}.	- lake
lamji	x_{1} is adjacent/beside/next to/in contact with x_{2} in property/sequence x_{3} in direction x_{4}.	- adjacent<br>- immediate; adjacent
lanbi	x_{1} is a quantity of protein/albumin of type x_{2} composed of amino acids (sequence/jo'u) x_{3} .	- protein
lanci	x_{1} is a flag/banner/standard of/symbolizing x_{2} with pattern(s) x_{3} on material x_{4}.	- flag
lanka	x_{1} is a basket with contents x_{2}, woven from material x_{3}.	- basket
lanli	x_{1} analyzes/examines-in-detail x_{2} by method/technique/system x_{3} [process/activity].	- analyze<br>- examine; analyze
lanme	x_{1} is a sheep/[lamb/ewe/ram] of species/breed x_{2} of flock x_{3}.	- sheep
lante	x_{1} is a can/tightly sealed/pre-sealed container for perishable contents x_{2}, made of x_{3}.	- can
lanxe	x_{1} is in balance/equilibrium under forces x_{2} (mass).	- balance
lanzu	x_{1} (mass) is a family with members including x_{2} bonded/tied/joined according to standard x_{3}.	- family
larcu	x_{1} (process) is an art [creative application] of craft/skill x_{2} (idea/activity).	- art
lasna	x_{1} (agent) fastens/connects/attaches/binds/lashes x_{2} to x_{3} with fastener x_{4}.	- fix; fasten<br>- fasten
lastu	x_{1} is a quantity of/contains/is made of brass [copper/zinc alloy] of composition including x_{2}.	- brass
latmo	x_{1} reflects Latin/Roman/Romance culture/empire/language in aspect x_{2}.	- Latin
latna	x_{1} is a lotus, plant/flower/herb of species/strain x_{2} symbolizing x_{3} to culture/religion x_{4}.	- lotus
lazni	x_{1} (person) is lazy/avoiding work/effort concerning action x_{2}.	- lazy
lebna	x_{1} takes/gets/gains/obtains/seizes/[removes] x_{2} (object/property) from x_{3} (possessor).	- gain; get<br>- take
lenjo	x_{1} is a lens/glass [focussing shape/form] focussing x_{2} to focus/foci x_{3} by means/material x_{4}.	- lens
lenku	x_{1} is cold/cool by standard x_{2}.	- cold
lerci	x_{1} (event) is late by standard x_{2}.	- late
lerfu	x_{1} (la'e zo BY/word-bu) is a letter/digit/symbol in alphabet/character-set x_{2} representing x_{3}.	- letter; letteral<br>- character; letteral<br>- letteral
libjo	x_{1} reflects Libyan culture/nationality in aspect x_{2}.	- Libyan
lidne	x_{1} precedes/leads x_{2} in sequence x_{3}; x_{1} is former/preceding/previous; x_{2} is latter/following.	- lead; precede<br>- precede; in sequence
lifri	x_{1} [person/passive/state] undergoes/experiences x_{2} (event/experience); x_{2} happens to x_{1}.	- face; deal with<br>- experience
lijda	x_{1} is a religion of believers including x_{2} sharing common beliefs/practices/tenets including x_{3}.	- religion
limna	x_{1} (agent) swims in fluid x_{2}.	- swim
lindi	x_{1} is lightning/electrical arc/thunderbolt striking at/extending to x_{2} from x_{3}.	- lightning
linji	x_{1} is a line/among lines [1-dimensional shape/form] defined by set of points x_{2}.	- line; mathematical
linsi	x_{1} is a length of chain/links of material x_{2} with link properties x_{3}.	- chain
linto	x_{1} is light in mass/weight by standard x_{2}.	- lightweight
lisri	x_{1} is a story/tale/yarn/narrative about plot/subject/moral x_{2} by storyteller x_{3} to audience x_{4}.	- story
liste	x_{1} (physical object) is a list/catalog/register of sequence/set x_{2} in order x_{3} in medium x_{4}.	- list
litce	x_{1} is x_{2} liter(s) [metric unit] in volume (default is 1) by standard x_{3}.	- liter
litki	x_{1} is liquid/fluid, of composition/material including x_{2}, under conditions x_{3}.	- liquid
litru	x_{1} travels/journeys/goes/moves via route x_{2} using means/vehicle x_{3}; x_{1} is a traveller.	- travel
livga	x_{1} is a/the liver [body-part] of x_{2}.	- liver
livla	x_{1} is a fuel/energy-source for powering x_{2}.	- fuel
logji	x_{1} [rules/methods] is a logic for deducing/concluding/inferring/reasoning to/about x_{2} (du'u).	- logic
lojbo	x_{1} reflects [Loglandic]/Lojbanic language/culture/nationality/community in aspect x_{2}.	- Lojbanic
loldi	x_{1} is a floor/bottom/ground of x_{2}.	- bottom; ground<br>- floor
lorxu	x_{1} is a fox [bushy-tailed wild dog/canine] of species/breed x_{2}.	- fox
lubno	x_{1} reflects Lebanese culture/nationality in aspect x_{2}.	- Lebanese
lujvo	x_{1} (text) is a compound predicate word with meaning x_{2} and arguments x_{3} built from metaphor x_{4}.	- affix compound
lumci	x_{1} (agent) washes/cleanses x_{2} of soil/contaminant x_{3} in/with cleaning material(s) x_{4}.	- wash
lunbe	x_{1} is bare/naked/nude; x_{1} is without cover/clothes/[protection].	- bare<br>- naked
lunra	x_{1} is Earth's moon (default); x_{1} is a major natural satellite/moon of planet x_{2}.	- lunar<br>- Moon
lunsa	x_{1} condenses/liquefies on/into x_{2} at temperature x_{3}, pressure x_{4}; x_{1} is dew/condensate on x_{2}.	- condense
mabla	x_1 is execrable/deplorable/wretched/shitty/awful/rotten/miserable/contemptible/crappy/inferior/low-quality in property x_2 by standard x_3; x_1 stinks/sucks in aspect x_2 according to x_3.	- execrable; very bad
mabru	x_{1} is a mammal/'animal'/beast of species x_{2}.	- mammal
macnu	x_{1} (event/action/process) is manual [not automatic] in function x_{2} under conditions x_{3}.	- manual; requiring sentient intervention
makcu	x_{1} is mature/ripe/fully-grown/adult in development-quality x_{2} (ka).	- mature
makfa	x_{1} is magic/supernatural/sorcery/witchcraft/wizardry to x_{2}, performed by person/force/deity x_{3}.	- magic
maksi	x_{1} is magnetic [adjective] producing magnetic field x_{2}.	- magnet
malsi	x_{1} is a temple/church/sanctuary/synagogue/shrine of religion x_{2} at location/serving area x_{3}.	- temple; place built for a divine
mamta	x_{1} is a mother of x_{2}; x_{1} bears/mothers/acts maternally toward x_{2}; [not necessarily biological].	- mother
manci	x_{1} feels wonder/awe/marvels about x_{2}.	- wonder; feeling awe
manfo	x_{1} (object/event) is uniform/homogeneous in property x_{2} (ka).	- uniform
manku	x_{1} is dark/lacking in illumination.	- dark
manri	x_{1} is a frame of reference/standard for observing/measuring/determining x_{2}, with/by rules x_{3}.	- reference
mansa	x_{1} satisfies evaluator x_{2} in property (ka)/state x_{3}.	- satisfy
manti	x_{1} is an ant of species/breed x_{2}.	- ant
mapku	x_{1} is a cap/hat/crown/helmet/piece of headgear [head-top garment] of material x_{2}.	- cap
mapni	x_{1} is a quantity of/contains/is made of cotton [type of fabric/material].	- cotton
mapti	x_{1} fits/matches/suits/is compatible/appropriate/corresponds to/with x_{2} in property/aspect x_{3}.	- proper; fit<br>- match; fit<br>- fit
marbi	x_{1} is a shelter/haven/refuge/retreat/harbor for/protecting x_{2} from danger/threat x_{3}.	- shelter
marce	x_{1} is a vehicle/mode of transport carrying x_{2} in/on surface/medium x_{3}, propelled by x_{4}.	- vehicle
marde	x_{1} are the ethics/morals/moral standards/ethical standards of x_{2} (ind./mass) about situation x_{3}.	- morals
margu	x_{1} is a quantity of/contains/made of mercury/quicksilver; [metaphor: fluid metal; temperature].	- mercury
marji	x_{1} is material/stuff/matter of type/composition including x_{2} in shape/form x_{3}.	- material<br>- matter; material
marna	x_{1} is a quantity of hemp/marijuana/jute of species/strain x_{2}.	- hemp
marxa	x_{1} [force] mashes/crushes/squashes/smashes x_{2} into pulp/mash/crumbs/deformed mass x_{3}.	- mash
masno	x_{1} is slow/sluggish at doing/being/bringing about x_{2} (event/state).	- slow
masti	x_{1} is x_{2} months in duration (default is 1 month) by month standard x_{3}.	- month
matci	x_{1} is a mat/pad/mattress/pallet [flat, soft, dense form] of material x_{2}.	- mat
matli	x_{1} is a quantity of/contains/is made of linen/flax [type of fabric/material].	- linen
matne	x_{1} is a quantity of/contains butter/oleo/margarine/shortening from source x_{2}.	- butter
matra	x_{1} is a motor/engine, driving/propelling/providing power to x_{2}.	- engine<br>- motor
mavji	x_{1} is a quantity of oats [grain] of species/strain x_{2}.	- oats
maxri	x_{1} is a quantity of wheat [grain] of species/strain x_{2}.	- wheat
mebri	x_{1} is a/the brow/forehead [projecting flat/smooth head/body-part] of x_{2}.	- brow<br>- forehead
megdo	x_{1} is a million [10^6] of x_{2} in dimension/aspect x_{3} (default is units).	- 1E6
mekso	x_{1} [quantifier/expression] is a mathematical expression interpreted under rules/convention x_{2}.	- MEX
melbi	x_{1} is beautiful/pleasant to x_{2} in aspect x_{3} (ka) by aesthetic standard x_{4}.	- gorgeous<br>- beautiful<br>- handsome
meljo	x_{1} reflects Malaysian/Malay culture/nationality/language in aspect x_{2}.	- Malaysian
menli	x_{1} is a mind/intellect/psyche/mentality/[consciousness] of body x_{2}.	- mind
mensi	x_{1} is a sister of/sororal to x_{2} by bond/tie/standard/parent(s) x_{3}; [not necessarily biological].	- sister
mentu	x_{1} is x_{2} minutes in duration (default is 1 minute) by standard x_{3}.	- minute
merko	x_{1} pertains to USA/American culture/nationality/dialect in aspect x_{2}.	- USA<br>- American; U.S.<br>- U.S.
merli	x_{1} (agent) measures/evaluates x_{2} [quantity] as x_{3} units on scale x_{4} (si'o), with accuracy x_{5}.	- measure
mexno	x_{1} reflects Mexican culture/nationality in aspect x_{2}.	- Mexican
midju	x_{1} is in/at the middle/center/midpoint/[is a focus] of x_{2}; (adjective:) x_{1} is central.	- center; middle<br>- middle
mifra	x_{1} is encoded/cipher text of plain-text x_{2} by code/coding system x_{3}; x_{1} is in code; x_{3} is a code.	- code
mikce	x_{1} doctors/treats/nurses/[cures]/is physician/midwife to x_{2} for ailment x_{3} by treatment/cure x_{4}.	- doctor
mikri	x_{1} is a millionth [10^{-6}] of x_{2} in dimension/aspect x_{3} (default is units).	- micro; latin prefix<br>- 1E-6
milti	x_{1} is a thousandth [1/1000; 10^{-3}] of x_{2} in dimension/aspect x_{3} (default is units).	- .001
milxe	x_{1} is mild/non-extreme/gentle/middling/somewhat in property x_{2} (ka); x_{1} is not very x_{2}.	- mild
minde	x_{1} issues commands/orders to x_{2} for result x_{3} (event/state) to happen; x_{3} is commanded to occur.	- command; an action<br>- order; issue a command
minji	x_{1} is a machine for use/function x_{2}; [automated apparatus, without direct function control].	- machine
minli	x_{1} is x_{2} (default 1) long local distance unit(s) [non-metric], x_{3} subunits, standard x_{4}.	- mile
minra	x_{1} reflects/mirrors/echoes x_{2} [object/radiation] to observer/point x_{3} as x_{4}; x_{2} bounces on x_{1}.	- reflect
mintu	x_{1} is the same/identical thing as x_{2} by standard x_{3}; (x_{1} and x_{2} interchangeable).	- same
mipri	x_{1} keeps x_{2} secret/hidden from x_{3} by method x_{4}; x_{2} is a secret; x_{1} hides/conceals x_{2}.	- secret
mirli	x_{1} is a deer/elk/moose/[hart/stag/doe] of species/breed x_{2}.	- deer
misno	x_{1} (person/object/event) is famous/renowned/is a celebrity among community of persons x_{2} (mass).	- famous
misro	x_{1} reflects Egyptian culture/nationality in aspect x_{2}.	- Egyptian
mitre	x_{1} is x_{2} meter(s) [metric unit] in length (default 1) measured in direction x_{3} by standard x_{4}.	- meter
mixre	x_{1} (mass) is a mixture/blend/colloid/commingling with ingredients including x_{2}.	- mixture
mlana	x_{1} is to the side of/lateral to x_{2} and facing x_{3} from point of view/in-frame-of-reference x_{4}.	- side; directional
mlatu	x_{1} is a cat/[puss/pussy/kitten] [feline animal] of species/breed x_{2}; (adjective:) x_{1} is feline.	- cat
mleca	x_{1} is less than x_{2} in property/quantity x_{3} (ka/ni) by amount x_{4}.	- less
mledi	x_{1} is a mold/fungus/mushrooms/truffles of species/strain x_{2} parasitic/growing on x_{3}.	- mold
mluni	x_{1} is a satellite/moon orbiting x_{2} with characteristics x_{3}, orbital parameters x_{4}.	- satellite<br>- moon; satellite
mokca	x_{1} is a point/instant/moment [0-dimensional shape/form] in/on/at time/place x_{2}.	- point; vertex
moklu	x_{1} is a/the mouth/oral cavity [body-part] of x_{2}; (metaphor: entrance/intake for consumption).	- mouth
molki	x_{1} is a mill/foundry/industrial plant/[assembly line] performing process x_{2}.	- mill
molro	x_{1} is x_{2} mole(s) [metric unit] in substance (default is 1) by standard x_{3}.	- mole
morji	x_{1} remembers/recalls/recollects fact(s)/memory x_{2} (du'u) about subject x_{3}.	- remember
morko	x_{1} reflects Moroccan culture/nationality in aspect x_{2}.	- Moroccan
morna	x_{1} is/reflects/represents a pattern of forms/events x_{2} arranged according to structure x_{3}.	- pattern
morsi	x_{1} is dead/has ceased to be alive.	- dead
mosra	x_{1} is friction [force opposing motion] due to contact/rubbing between x_{2} and x_{3}; (fe) x_{2} rubs x_{3}.	- friction
mraji	x_{1} is a quantity of rye [grain] of species/strain x_{2}.	- rye
mrilu	x_{1} mails/posts [transfer via intermediary service] x_{2} to recipient address x_{3} from mailbox/post office/sender address x_{4} by carrier/network/system x_{5}.	- mail; send mail<br>- post; send mail
mruli	x_{1} [tool] is a hammer for/hammers x_{2} [target] consisting of weight/head x_{3} propelled by x_{4}.	- hammer
mucti	x_{1} is immaterial/not physical/without material form.	- immaterial
mudri	x_{1} is a quantity of/is made of/contains wood/lumber from tree(s) of type/species x_{2}.	- wood; the material
mukti	x_{1} (action/event/state) motivates/is a motive/incentive for action/event x_{2}, per volition of x_{3}.	- motive
mulno	x_{1} (event) is complete/done/finished; x_{1} (object) has become whole in property x_{2} by standard x_{3}.	- perfected; finished<br>- finished<br>- complete; finished<br>- fully; completely<br>- wholly<br>- done; finished<br>- entirely<br>- entire
munje	x_{1} is a universe/cosmos [complete and ordered entirety] of domain/sphere x_{2} defined by rules x_{3}.	- universe
mupli	x_{1} is an example/sample/specimen/instance/case/illustration of common property(s) x_{2} of set x_{3}.	- sample; specimen<br>- example
murse	x_{1} is the [astronomical] twilight/dawn/dusk/half-light/glimmering of day x_{2} at location x_{3}.	- glimmering
murta	x_{1} is a curtain/blinds/drapes for covering/obscuring aperture x_{2}, and made of material x_{3}.	- curtain
muslo	x_{1} pertains to the Islamic/Moslem/Koranic [Quranic] culture/religion/nation in aspect x_{2}.	- Islamic<br>- Muslim<br>- Moslem<br>- Quranic<br>- Koranic
mutce	x_{1} is much/extreme in property x_{2} (ka), towards x_{3} extreme/direction; x_{1} is, in x_{2}, very x_{3}.	- extreme; in the greatest degree<br>- very; to a great extent<br>- much
muvdu	x_{1} (object) moves to destination/receiver x_{2} [away] from origin x_{3} over path/route x_{4}.	- move; non-agentive
muzga	x_{1} is a museum for preserving [and possibly exhibiting] x_{2} at location x_{3}.	- museum
nabmi	x_{1} (event/state) is a problem to/encountered by x_{2} in situation/task/inquiry x_{3}.	- problem
nakni	x_{1} is a male/buck of species x_{2} evidencing masculine trait(s) x_{3} (ka); x_{1} is masculine.	- male
nalci	x_{1} is a/the wing [body-part] of x_{2}; [metaphor: lateral supporting surface].	- wing
namcu	x_{1} (li) is a number/quantifier/digit/value/figure (noun); refers to the value and not the symbol.	- number; a quantity
nanba	x_{1} is a quantity of/contains bread [leavened or unleavened] made from grains x_{2}.	- bread
nanca	x_{1} is x_{2} years in duration (default is 1 year) by standard x_{3}; (adjective:) x_{1} is annual.	- year
nandu	x_{1} is difficult/hard/challenging for x_{2} under conditions x_{3}; x_{1} challenges (non-agentive) x_{2}.	- hard; difficult<br>- difficult
nanla	x_{1} is a boy/lad [young male person] of age x_{2} immature by standard x_{3}.	- boy
nanmu	x_{1} is a man/men; x_{1} is a male humanoid person [not necessarily adult].	- man
nanvi	x_{1} is a billionth/thousand-millionth [10^{-9}] of x_{2} in dimension/aspect x_{3} (default is units).	- nano<br>- 1E-9
narge	x_{1} is a nut [body-part: hard-shelled fruit] from plant/species x_{2} with shell x_{3} and kernel x_{4}.	- nut
narju	x_{1} is orange [color adjective].	- orange; the colour
natfe	x_{1} (du'u) contradicts/denies/refutes/negates x_{2} (du'u) under rules/logic x_{3}.	- contradict; negate<br>- refute; negate<br>- deny
natmi	x_{1} is a nation/ethnic group of peoples x_{2}; [people sharing a history/culture].	- nation
navni	x_1 is a quantity of/contains/is made of noble gas of type x_2 [helium/neon/argon/krypton/xenon/radon].	- neon<br>- noble gas
naxle	x_{1} is a canal/channel to x_{2} from x_{3} with route x_{4}.	- canal
nazbi	x_{1} is the nose [body-part] of x_{2} with nostril(s)/nasal passage(s) x_{3}; [metaphor: protrusion].	- nose
nejni	x_{1} is energy of type x_{2} in form x_{3}.	- energy
nelci	x_{1} is fond of/likes/has a taste for x_{2} (object/state).	- like; be fond of<br>- fond
nenri	x_{1} is in/inside/within x_{2}; x_{1} is on the inside/interior of x_{2} [totally within the bounds of x_{2}].	- in
nibli	x_{1} logically necessitates/entails/implies action/event/state x_{2} under rules/logic system x_{3}.	- necessitate
nicte	x_{1} is a nighttime of day x_{2} at location x_{3}; (adjective:) x_{1} is at night/nocturnal.	- night
nikle	x_{1} is made of/contains/is a quantity of nickel/other metal resistant to oxidation.	- nickel
nilce	x_{1} [furniture items] furnishes x_{2} [location] serving purpose/function x_{3}.	- furniture
nimre	x_{1} is a quantity of citrus [fruit/tree, etc.] of species/strain x_{2}.	- citrus
ninmu	x_{1} is a woman/women; x_{1} is a female humanoid person [not necessarily adult].	- woman
nirna	x_{1} is a nerve/neuron [body-part] of x_{2}; [metaphor: information/control network connection].	- nerve
nitcu	x_{1} needs/requires/is dependent on/[wants] necessity x_{2} for purpose/action/stage of process x_{3}.	- need
nivji	x_{1} (agent) knits x_{2} [cloth/object] from yarn/thread x_{3}.	- knit
nixli	x_{1} is a girl [young female person] of age x_{2} immature by standard x_{3}.	- girl
nobli	x_{1} is noble/aristocratic/elite/high-born/titled in/under culture/society/standard x_{2}.	- noble
notci	x_{1} is a message/notice/memorandum about subject x_{2} from author x_{3} to intended audience x_{4}.	- message
nukni	x_{1} is magenta/fuchsia/purplish-red [color adjective].	- magenta
nupre	x_{1} (agent) promises/commits/assures/threatens x_{2} (event/state) to x_{3} [beneficiary/victim].	- promise; commit to something
nurma	x_{1} is a rural/rustic/pastoral area of x_{2}; x_{1} is in the country.	- rural
nutli	x_{1} is neutral/not taking sides/medial/not towards any extreme on scale/in dissension x_{2}.	- neutral
nuzba	x_{1} (du'u) is news/tidings/new information about subject x_{2} from source x_{3}, to observer x_{4}.	- news
pacna	x_{1} hopes/wishes for/desires x_{2} (event), expected likelihood x_{3} (0-1); x_{1} hopes that x_{2} happens.	- wish; hope, expect
pagbu	x_{1} is a part/component/piece/portion/segment of x_{2} [where x_{2} is a whole/mass]; x_{2} is partly x_{1}.	- part
pagre	x_{1} passes through/penetrates barrier/medium/portal x_{2} to destination side x_{3} from origin side x_{4}.	- pass through
pajni	x_{1} judges/referees/arbitrates/is a judge determining/deciding matter x_{2} (abstract).	- judge
palci	x_{1} is evil/depraved/wicked [morally bad] by standard x_{2}.	- evil
palku	x_{1} are pants/trousers/slacks/leggings [legged garment] of material x_{2}.	- pants<br>- trousers<br>- slacks; trousers
palne	x_{1} is a tray/platter/flat container [pan/sheet/griddle] of contents x_{2}, and made of material x_{3}.	- tray
palta	x_{1} is a plate/dish/platter/saucer [flat/mildly concave food service bed] made of material x_{2}.	- plate
pambe	x_{1} is a pump/injector [tool/apparatus] pumping/inserting fluid x_{2} to x_{3} from x_{4} by means x_{5}.	- pump
panci	x_{1} is an odor/fragrance/scent/smell emitted by x_{2} and detected by observer/sensor x_{3}.	- odor
pandi	x_{1} (agent) punctuates x_{2} (expression) with symbol/word x_{3} with syntactic/semantic effect x_{4}.	- punctuate
panje	x_{1} is a quantity of/contains/is made of sponge/porous material.	- sponge; porous material
panka	x_{1} is a park/land reserve managed by community/polity/company x_{2} for purpose x_{3}.	- park; land reserve
panlo	x_{1} is a slice [thin flat portion] of x_{2} (mass).	- slice
panpi	x_{1} is at peace with x_{2}.	- peace
panra	x_{1} parallels x_{2} differing only in property x_{3} (ka; jo'u/fa'u term) by standard/geometry x_{4}.	- parallel
pante	x_{1} protests/objects to/complains about x_{2} (event/state) to audience x_{3} with action x_{4}.	- protest
panzi	x_{1} is a [biological] offspring/child/kid/hybrid of parent(s) x_{2}; (adjective:) x_{1} is filial.	- offspring
papri	x_{1} is a [physical] page/leaf of book/document/bound mass of pages x_{2}.	- page
parbi	x_{1} (me'o, fraction) is a ratio/rate of x_{2} (quantity) with respect to x_{3} (quantity), [x_{2}:x_{3}].	- rate; amount measured in relation to another amount<br>- ratio
pastu	x_{1} is a robe/tunic/gown/cloak/dress/[coveralls] [a long/full body garment] of material x_{2}.	- robe<br>- dress; garment
patfu	x_{1} is a father of x_{2}; x_{1} begets/sires/acts paternal towards x_{2}; [not necessarily biological].	- father
patlu	x_{1} is a potato [an edible tuber] of variety/cultivar x_{2}.	- potato
patxu	x_{1} is a pot/kettle/urn/tub/sink, a deep container for contents x_{2}, of material/properties x_{3}.	- pot
pelji	x_{1} is paper from source x_{2}.	- paper
pelxu	x_{1} is yellow/golden [color adjective].	- yellow
pemci	x_{1} is a poem/verse about plot/theme/subject/pattern x_{2} by author x_{3} for intended audience x_{4}.	- poem
penbi	x_{1} is a pen using ink x_{2} applied by process x_{3}.	- pen
pencu	x_{1} (agent) touches x_{2} with x_{3} [a locus on x_{1} or an instrument] at x_{4} [a locus on x_{2}].	- touch
pendo	x_{1} is/acts as a friend of/to x_{2} (experiencer); x_{2} befriends x_{1}.	- friend
penmi	x_{1} meets/encounters x_{2} at/in location x_{3}.	- meet
pensi	x_{1} thinks/considers/cogitates/reasons/is pensive about/reflects upon subject/concept x_{2}.	- think; on a topic
perli	x_{1} is a pear [fruit] of species/strain x_{2}.	- pear
pesxu	x_{1} is paste/pulp/dough/mash/mud/slurry [soft, smooth-textured, moist solid] of composition x_{2}.	- paste
petso	x_{1} is 10^{15} of x_{2} in dimension/aspect x_{3} (default is units).	- 1E15
pezli	x_{1} is a leaf of plant x_{2}; x_{1} is foliage of x_{2}.	- leaf
picti	x_{1} is a trillionth [10^{-12}] of x_{2} in dimension/aspect x_{3} (default is units).	- 1E-12<br>- trillionth
pijne	x_{1} is a pin/peg (needle-shaped tool) for fastening to/piercing x_{2}, of material/properties x_{3}.	- pin
pikci	x_{1} begs/pleads/supplicates/entreats/implores/beseeches/prays [asks with humility] x_{2} for x_{3}.	- beg
pikta	x_{1} is a ticket entitling x_{2} to entitlement/privilege x_{3} (event/state) under conditions x_{4}.	- ticket
pilji	x_{1} is the product/total/result of factors/multiplicands (x_{2} and x_{3}) x_{2} multiplied by x_{3}.	- multiply; mathematical
pilka	x_{1} is a crust/rind/peel/skin/hide/outer cover of x_{2}.	- crust
pilno	x_{1} uses/employs x_{2} [tool, apparatus, machine, agent, acting entity, material] for purpose x_{3}.	- use
pimlu	x_{1} is a/the feather/plume(s)/plumage [body-part] of animal/species x_{2}.	- feather
pinca	x_{1} is a/the urine/piss/pee of x_{2}.	- urine
pindi	x_{1} is poor/indigent/impoverished/lacking in goods/possessions/property x_{2}.	- poor
pinfu	x_{1} is a prisoner/captive of x_{2}, restrained/held/confined by means/force x_{3}.	- prisoner
pinji	x_{1} is a/the clitoris/penis [projecting reproductive organ; body-part] of x_{2}.	- clitoris<br>- penis
pinka	x_{1} (text) is a comment/remark/observation about subject x_{2} expressed by x_{3} to audience x_{4}.	- remark; comment<br>- comment
pinsi	x_{1} is a pencil/crayon/stylus applying lead/marking material x_{2}, frame/support [of material] x_{3}.	- pencil
pinta	x_{1} is flat/level/horizontal in gravity/frame of reference x_{2}.	- flat; having no variations in altitude<br>- horizontal<br>- level
pinxe	x_{1} (agent) drinks/imbibes beverage/drink/liquid refreshment x_{2} from/out-of container/source x_{3}.	- drink
pipno	x_{1} is a piano/harpsichord/synthesizer/organ; a keyboard musical instrument.	- piano
pixra	x_{1} is a picture/illustration representing/showing x_{2}, made by artist x_{3} in medium x_{4}.	- picture
plana	x_{1} is plump/fat/obese [excessively thick/bulbous/swollen] by standard x_{2}.	- plump<br>- fat; obese
platu	x_{1} (agent) plans/designs/plots plan/arrangement/plot/[schematic] x_{2} for state/process x_{3}.	- measure; tactic/strategy<br>- plan
pleji	x_{1} pays/compensates/remunerates/[rewards] payment x_{2} to recipient/payee x_{3} for goods/services x_{4}.	- pay
plibu	x_{1} is a/the pubic area/external genitalia [body-part] of x_{2}.	- pubic
plini	x_{1} is a planet revolving around x_{2} with planetary characteristics x_{3}, orbital parameters x_{4}.	- planet
plipe	x_{1} (agent/object) leaps/jumps/springs/bounds to x_{2} from x_{3} reaching height x_{4} propelled by x_{5}.	- jump; to spring clear of the ground or other support<br>- leap
plise	x_{1} is an apple [fruit] of species/strain x_{2}.	- apple
plita	x_{1} is a plane [2-dimensional shape/form] defined by points x_{2} (set); x_{1} is flat/[smooth].	- plane; 2-D space
plixa	x_{1} (agent) plows/furrows/tills [cuts into and turns up] x_{2} with tool x_{3} propelled by x_{4}.	- plow; to turn earth
pluja	x_{1} is complex/complicated/involved in aspect/property x_{2} (ka) by standard x_{3}.	- complicated
pluka	x_{1} (event/state) seems pleasant to/pleases x_{2} under conditions x_{3}.	- pleasant<br>- please; give pleasure
pluta	x_1 is a route/path/way/course/track to x_2 from x_3 via/defined by points including x_4 (set).	- path; route<br>- way; path<br>- route; any path along defined points
polje	x_{1} (force) folds/creases x_{2} at locus/loci/forming crease(s)/bend(s) x_{3}.	- fold
polno	x_{1} reflects Polynesian/Oceanian (geographic region) culture/nationality/languages in aspect x_{2}.	- Polynesian
ponjo	x_{1} reflects Japanese culture/nationality/language in aspect x_{2}.	- Japanese
ponse	x_{1} possesses/owns/has x_{2} under law/custom x_{3}; x_{1} is owner/proprietor of x_{2} under x_{3}.	- possess
porpi	x_{1} breaks/fractures/shatters/[splits/splinters/cracks] into pieces x_{2}.	- break
porsi	x_{1} [ordered set] is sequenced/ordered/listed by comparison/rules x_{2} on unordered set x_{3}.	- sequence
porto	x_{1} reflects Portuguese culture/nationality/language in aspect x_{2}.	- Portuguese
prali	x_{1} is a profit/gain/benefit/advantage to x_{2} accruing/resulting from activity/process x_{3}.	- profit<br>- gain; profit
prami	x_{1} loves/feels strong affectionate devotion towards x_{2} (object/state).	- love
prane	x_{1} is perfect/ideal/archetypical/faultless/flawless/un-improvable in property/aspect x_{2} (ka).	- perfect<br>- ideal; perfect
preja	x_{1} spreads/expands over/into x_{2} from initial state x_{3}.	- spread; expand
prenu	x_{1} is a person/people (noun) [not necessarily human]; x_{1} displays personality/a persona.	- person<br>- people
preti	x_{1} (quoted text) is a question/query about subject x_{2} by questioner x_{3} to audience x_{4}.	- question
prije	x_{1} is wise/sage about matter x_{2} (abstraction) to observer x_{3}.	- wise
prina	x_{1} is a print/impression/image on/in surface x_{2} of/made by/using tool/press/implement/object x_{3}.	- print
pritu	x_{1} is to the right/right-hand side of x_{2} which faces/in-frame-of-reference x_{3}.	- right
prosa	x_{1} is prose about plot/theme/subject x_{2} by author x_{3} for intended audience x_{4}.	- prose
pruce	x_{1} is a process with inputs x_{2}, outputs/results x_{3}, passing through steps/stages x_{4}.	- course; onward process<br>- process; regulated series of steps
pruni	(adjective:) x_{1} is elastic/springy.	- elastic
pruxi	x_{1} is spiritual/pertains to the soul in nature [either energy or being]; x_{1} is ghostly/ethereal.	- spirit
pulce	x_{1} is dust/precipitate [suspensible solid] from x_{2} in medium/on surface x_{3}.	- precipitate; suspensible solid<br>- dust
pulji	x_{1} is a police officer/[enforcer/vigilante] enforcing law(s)/rule(s)/order x_{2}.	- police
pulni	x_{1} is a pulley [tool] for performing action/function x_{2} rotating on axle x_{3}.	- pulley
punji	x_{1} (agent) puts/places/sets x_{2} on/at surface/locus x_{3}.	- put
punli	x_{1} is a swelling/protrusion/convexity [shape/form] at/in/on x_{2}, of material x_{3}.	- swelling
purci	x_{1} is in the past of/earlier than/before x_{2} in time sequence; x_{1} is former; x_{2} is latter.	- past
purdi	x_{1} is a garden/tended/cultivated field of family/community/farmer x_{2} growing plants/crop x_{3}.	- garden
purmo	x_{1} is a powder of material x_{2}.	- powder
racli	x_{1} (action/activity/behavior) is sane/rational by standard x_{2}.	- sane
ractu	x_{1} is a rabbit/hare/[doe] of species/breed x_{2}.	- bunny; rabbit<br>- rabbit
radno	x_{1} is x_{2} radian(s) [metric unit] in angular measure (default is 1) by standard x_{3}.	- radian
rafsi	x_{1} is an affix/suffix/prefix/combining-form for word/concept x_{2}, form/properties x_{3}, language x_{4}.	- affix
ragve	x_{1} is located across/on the other side of gap/boundary x_{2} from x_{3}; x_{1} is opposite (fi) x_{3}.	- across
rakso	x_{1} reflects Iraqi culture/nationality in aspect x_{2}.	- Iraqi
raktu	x_{1} (object/person/event/situation) troubles/disturbs x_{2} (person) causing problem(s) x_{3}.	- trouble
ralci	x_{1} is delicate/fragile/subtle/refined in property x_{2} (ka).	- delicate
ralju	x_{1} is principal/chief/leader/main/[staple], most significant among x_{2} (set) in property x_{3} (ka).	- principal
ralte	x_{1} retains/keeps/holds x_{2} in its possession.	- retain<br>- keep; maintain possession of<br>- hold; have and keep possession of
randa	x_{1} yields/gives way/surrenders to x_{2} (force/agent) under conditions x_{3}.	- yield
rango	x_{1} is a/the body organ [body-part] of body/species x_{2} performing function x_{3}.	- organ
ranji	x_{1} (event/state) continues/persists over interval x_{2}; x_{1} (property - ka) is continuous over x_{2}.	- continue
ranmi	x_{1} is a myth/legend, a culturally significant story about x_{2} in mythos x_{3} of culture x_{4}.	- myth
ransu	x_{1} is a quantity of/contains/is made of bronze of composition including x_{2}.	- bronze
ranti	x_{1} is soft/malleable/moldable/yielding to force x_{2} in conditions x_{3}.	- soft
ranxi	x_{1} is ironic(al)/contrary to expectation x_{2} in state/property/aspect x_{3}.	- irony
rapli	x_{1} [action] repeats/is repeated for a total of x_{2} (quantity) occurrences.	- repeat; re-occuring action
rarna	x_{1} is natural/spontaneous/instinctive, not [consciously] caused by person(s).	- natural
ratcu	x_{1} is a rat of species/breed x_{2}.	- rat
ratni	x_{1} is an atom of element/atomic number x_{2} of isotope number/atomic weight x_{3}.	- atom
rebla	x_{1} is a/the tail/appendix [body-part] of x_{2}; [metaphor: trailing, following portion/appendage].	- tail
rectu	x_{1} is a quantity of/contains meat/flesh from source/animal x_{2}.	- meat
remna	x_{1} is a human/human being/man (non-specific gender-free sense); (adjective:) x_{1} is human.	- human
renro	x_{1} throws/launches/casts/hurls x_{2} to/at/in direction x_{3} (propulsion derives internally to x_{1}).	- throw
renvi	x_{1} survives/endures/undergoes/abides/lasts/persists through x_{2} for interval/duration x_{3}.	- survive
respa	x_{1} is a reptile of species/breed x_{2}.	- reptile
ricfu	x_{1} is rich/wealthy in goods/possessions/property/aspect x_{2}.	- rich
rigni	x_{1} is repugnant to/causes disgust to x_{2} under conditions x_{3}.	- disgusting
rijno	x_{1} is made of/contains/is a quantity of silver/argentum (Ag); [metaphor: valuable, tarnishing].	- silvery; made of silver (Ag)<br>- silver
rilti	x_{1} (sequence/non-text quote) is a rhythm/beat of music/expressive form x_{2}.	- beat; rhythm<br>- rhythm
rimni	x_{1} rhymes/alliterates with x_{2} in language/phonetics x_{3}, matching sound correspondence x_{4} (ka).	- rhyme
rinci	x_{1} liquid/fluid drains/strains/flushes from source x_{2} through drain/strainer x_{3} by force x_{4}.	- drain
rinju	x_{1} is restrained/held [back]/constrained/kept by restraint x_{2} against x_{3} (event).	- restrain
rinka	x_{1} (event/state) effects/physically causes effect x_{2} (event/state) under conditions x_{3}.	- cause
rinsa	x_{1} (agent) greets/hails/[welcomes/says hello to]/responds to arrival of x_{2} in manner x_{3} (action).	- greet
rirci	x_{1} [member] is rare/unusual/uncommon/atypical in property x_{2} (ka) among members of x_{3} (set).	- special; distinguished by a unique/unusual quality<br>- rare
rirni	x_{1} is a parent of/raises/rears x_{2}; x_{1} mentors/acts parental toward child/protege x_{2}.	- parent
rirxe	x_{1} is a river of land mass x_{2}, draining watershed x_{3} into x_{4}/terminating at x_{4}.	- river
rismi	x_{1} is a quantity of rice [a type of grain] of strain/cultivar x_{2}.	- rice
risna	x_{1} is a/the heart [body-part] of x_{2}; [emotional/shape metaphors are NOT culturally neutral].	- heart; body part
ritli	x_{1} is a rite/ceremony/ritual for purpose/goal x_{2}, by custom/in community x_{3}, with form/rules x_{4}.	- rite
rivbi	x_{1} avoids/evades/shuns/escapes/skirts [fate] x_{2} (event) through action/state x_{3} (event).	- escape; avoid<br>- avoid
rokci	x_{1} is a quantity of/is made of/contains rock/stone of type/composition x_{2} from location x_{3}.	- rock
romge	x_{1} is a highly reflective/polished non-tarnishing metallic surface, of metal x_{2} [often chromium].	- chrome
ropno	x_{1} reflects European culture/nationality/geography/Indo-European languages in aspect x_{2}.	- European
rorci	x_{1} engenders/procreates/begets x_{2} with coparent x_{3}.	- procreate
rotsu	x_{1} is thick in dimension/direction x_{2} by standard x_{3}; [relatively long in smallest dimension].	- thick
rozgu	x_{1} is a rose [flower - characterized by prickly stem/fragrance] of species/strain x_{2}.	- rose
ruble	x_{1} is weak/feeble/frail in property/quality/aspect x_{2} (ka) by standard x_{3}.	- weak
rufsu	x_{1} is rough/coarse/uneven/[grainy/scabrous/rugged] in texture/regularity.	- rough
runme	x_{1} melts [becomes liquid from solid state] at temperature x_{2} and pressure x_{3}.	- melt
runta	x_{1} dissolves in solvent x_{2} forming solution/[suspension] x_{3} under conditions x_{4}.	- dissolve
rupnu	x_{1} is measured in major-money-units (dollar/yuan/ruble) as x_{2} (quantity), monetary system x_{3}.	- dollar
rusko	x_{1} reflects Russian culture/nationality/language in aspect x_{2}.	- Russian
rutni	x_{1} is an artifact; x_{1} is artificial; x_{1} is made/caused by people/se kulnu x_{2}; x_{1} is man-made.	- artifact
sabji	x_{1} [source] provides/supplies/furnishes x_{2} [supply/commodity] to x_{3} [recipient].	- provide
sabnu	x_{1} is a cabin of vehicle x_{2}.	- cabin
sacki	x_{1} is a match [incendiary device] made of x_{2}.	- match; incendiary device
saclu	x_{1} (me'o) is the [decimal/binary] equivalent of fractional x_{2} (me'o) in base x_{3} (quantity).	- decimal
sadjo	x_{1} reflects Saudi Arabian culture/nationality in aspect x_{2}.	- Saudi
sakci	x_{1} sucks/is suction/vacuum/relatively low pressure of fluid/gas x_{2} relative to high pressure x_{3}.	- suck
sakli	x_{1} slides/slips/glides on x_{2}.	- slide
sakta	x_{1} is made of/contains/is a quantity of sugar [sweet edible] from source x_{2} of composition x_{3}.	- sugar
salci	x_{1} celebrates/recognizes/honors x_{2} (event/abstract) with activity/[party] x_{3}.	- celebrate
salpo	x_{1} is sloped/inclined/slanted/aslant with angle x_{2} to horizon/frame x_{3}.	- slope
salta	x_{1} (mass) is a quantity of salad [food] with ingredients/components including x_{2}.	- salad
samcu	x_{1} is a quantity of cassava/taro/manioc/tapioca/yam [edible starchy root] of species/strain x_{2}.	- cassava
sampu	x_{1} is simple/unmixed/uncomplicated in property x_{2} (ka).	- simple
sance	x_{1} is sound produced/emitted by x_{2}.	- sound
sanga	x_{1} sings/chants x_{2} [song/hymn/melody/melodic sounds] to audience x_{3}.	- sing
sanji	x_{1} is conscious/aware of x_{2} (object/abstract); x_{1} discerns/recognizes x_{2} (object/abstract).	- conscious<br>- recognize; discern
sanli	x_{1} stands [is vertically oriented] on surface x_{2} supported by limbs/support/pedestal x_{3}.	- stand
sanmi	x_{1} (mass) is a meal composed of dishes including x_{2}.	- meal
sanso	x_{1} is a sauce/topping/gravy/frosting for use with x_{2}, containing ingredient(s) including x_{3}.	- sauce
santa	x_{1} is an umbrella/parasol shielding x_{2} from x_{3}, made of material x_{4}, supported by x_{5}.	- umbrella
sarcu	x_{1} (abstract) is necessary/required for continuing state/process x_{2} under conditions x_{3}.	- must; necessary<br>- necessary
sarji	x_{1} supports/holds up/is underpinning of/[helps] x_{2} against force/opposition x_{3} with/by means x_{4}.	- support
sarlu	x_{1} is a spiral/helix/whorl/[vortex] [shape/form] with limits x_{2}, of dimensionality x_{3}.	- spiral
sarxe	x_{1} is harmonious/concordant/in agreement/concord with x_{2} in property x_{3} (ka).	- harmonious
saske	x_{1} (mass of facts) is science of/about subject matter x_{2} based on methodology x_{3}.	- science<br>- lore; body of knowledge
satci	x_{1} [measurement/match] is exact/precise to precision x_{2} in property/quantity x_{3} (ka/ni).	- exact
satre	x_{1} (agent) strokes/rubs/pets x_{2} with x_{3}.	- stroke
savru	x_{1} is a noise/din/clamor [sensory input without useful information] to x_{2} via sensory channel x_{3}.	- noise
sazri	x_{1} operates/drives/runs x_{2} [apparatus/machine] with goal/objective/use/end/function x_{3}.	- operate
sefta	x_{1} is surface/face [bounded shape/form] of [higher-dimension] object x_{2}, on side x_{3}, edges x_{4}.	- surface
selci	x_{1} is a cell/atom/unit/molecule of x_{2}; x_{1} is an indivisible, most basic subunit of x_{2}.	- cell
selfu	x_{1} (agent) serves x_{2} with service x_{3} (activity); x_{1} is a servant (noun) of x_{2} performing x_{3}.	- serve
semto	x_{1} reflects Semitic [metaphor: Middle-Eastern] language/culture/nationality in aspect x_{2}.	- Semitic
senci	x_{1} sneezes (intransitive verb).	- sneeze
senpi	x_{1} doubts/is dubious/doubtful/skeptical/questions that x_{2} (du'u) is true.	- doubt
senta	x_{1} is a layer/stratum [shape/form] of x_{2} [material] within structure/continuum/composite x_{3}.	- layer
senva	x_{1} dreams about/that x_{2} (fact/idea/event/state); x_{2} is a dream/reverie of x_{1}.	- dream
sepli	x_{1} is apart/separate from x_{2}, separated by partition/wall/gap/interval/separating medium x_{3}.	- apart<br>- spaced; be separated to a distance
serti	x_{1} are stairs/stairway/steps for climbing structure x_{2} with steps x_{3}.	- stairs
setca	x_{1} (agent) inserts/interposes/puts/deposits x_{2} into interior x_{3}/into among/between members of x_{3}.	- insert
sevzi	x_{1} is a self/ego/id/identity-image of x_{2}.	- self
sfani	x_{1} is a fly [a small non-stinging flying insect] of species/breed x_{2}.	- fly
sfasa	x_{1} (agent) punishes x_{2} for infraction x_{3} (event/state/action) with punishment x_{4} (event/state).	- punish
sfofa	x_{1} is a sofa/couch (noun).	- sofa
sfubu	x_{1} dives/swoops [manner of controlled falling] to x_{2} from x_{3}.	- dive
siclu	x_{1} [sound source] whistles/makes whistling sound/note/tone/melody x_{2}.	- whistle
sicni	x_{1} is a coin/token/is specie issued by x_{2} having value x_{3} of composition including x_{4}.	- coin
sidbo	x_{1} (idea abstract) is an idea/concept/thought about x_{2} (object/abstract) by thinker x_{3}.	- idea
sidju	x_{1} helps/assists/aids object/person x_{2} do/achieve/maintain event/activity x_{3}.	- help
sigja	x_{1} is a cigar/cigarette/cigarillo made from tobacco/smokable substance x_{2} by x_{3}.	- cigar
silka	x_{1} is a quantity of/contains/is made of silk produced by x_{2}.	- silk
silna	x_{1} is a portion/quantity of salt from source x_{2}, of composition including x_{3}.	- salt
simlu	x_{1} seems/appears to have property(ies) x_{2} to observer x_{3} under conditions x_{4}.	- seem
simsa	x_{1} is similar/parallel to x_{2} in property/quantity x_{3} (ka/ni); x_{1} looks/appears like x_{2}.	- similar
simxu	x_{1} (set) has members who mutually/reciprocally x_{2} (event [x_{1} should be reflexive in 1+ sumti]).	- mutual
since	x_{1} is a snake/serpent of species/breed x_{2}.	- snake
sinma	x_{1} esteems/respects/venerates/highly regards x_{2} [object of respect].	- honor; respect<br>- respect; have respect for<br>- esteem
sinso	x_{1} is the trigonometric sine of angle/arcsine x_{2}.	- sine
sinxa	x_{1} is a sign/symbol/signal representing/referring/signifying/meaning x_{2} to observer x_{3}.	- signal<br>- represent; serve as a sign or symbol of<br>- sign
sipna	x_{1} is asleep (adjective); x_{1} sleeps/is sleeping.	- sleep
sirji	x_{1} is straight/direct/line segment/interval between x_{2} and x_{3}; (adjective:)  x_{1} is linear.	- straight; of a line
sirxo	x_{1} reflects Syrian culture/nationality in aspect x_{2}.	- Syrian
sisku	x_{1} seeks/searches/looks for property x_{2} among set x_{3} (complete specification of set).	- seek
sisti	x_{1} [agent] ceases/stops/halts/ends activity/process/state x_{2} [not necessarily completing it].	- end; terminate<br>- stop; cause something to halt<br>- cease; agentive<br>- halt; cause something to stop
sitna	x_{1} cites/quotes/refers to/makes reference to source x_{2} for information/statement x_{3} (du'u).	- refer; make reference to<br>- cite
sivni	x_{1} is private/personal/privy/[secret/confidential/confined] to x_{2}; x_{1} is not-public/hidden.	- private
skaci	x_{1} is a skirt/kilt/dress of material x_{2}; x_{1} is skirted [garment open at the bottom; not legged].	- skirt
skami	x_{1} is a computer for purpose x_{2}.	- computer
skapi	x_{1} is a pelt/skin/hide/leather from x_{2}.	- pelt
skari	x_{1} is/appears to be of color/hue x_{2} as perceived/seen by x_{3} under conditions x_{4}.	- color
skicu	x_{1} tells about/describes x_{2} (object/event/state) to audience x_{3} with description x_{4} (property).	- describe
skiji	x_{1} is a ski/skid/skate/runner for surface (of material) x_{2} supporting skier/skater/sled/cargo x_{3}.	- ski
skina	x_{1} is a cinema/movie/film about x_{2} [plot/theme/subject/activity], filmmaker x_{3}, for audience x_{4}.	- film; motion picture<br>- cinema
skori	x_{1} is cord/cable/rope/line/twine/cordage/woven strands of material x_{2}.	- rope<br>- cord
skoto	x_{1} reflects Gaelic/Scottish culture/nationality/language in aspect x_{2}.	- Scottish
skuro	x_{1} is a groove/trench/furrow [shape/form] in object/surface x_{2}.	- groove
slabu	x_{1} is old/familiar/well-known to observer x_{2} in feature x_{3} (ka) by standard x_{4}.	- familiar
slaka	x_{1} is a syllable in language x_{2}.	- syllable
slami	x_{1} is a quantity of/contains/is made of acid of composition x_{2}; (adjective:) x_{1} is acidic.	- acid
slanu	x_{1} is a cylinder [shape/form] of material x_{2}.	- cylinder
slari	x_{1} is sour/tart to observer x_{2}.	- sour
slasi	x_{1} is a quantity of/is made of/contains plastic/polymer of type/component unit(s) x_{2}.	- plastic
sligu	x_{1} is solid, of composition/material including x_{2}, under conditions x_{3}.	- solid; not liquid or gaseous
slilu	x_{1} oscillates at rate/frequency x_{2} through set/sequence-of-states x_{3} (complete specification).	- oscillate
sliri	x_{1} is a quantity of/contains/is made of sulfur/brimstone (S); [metaphor: foul odor, volcanic].	- sulfur
slovo	x_{1} reflects Slavic language/culture/ethos in aspect x_{2}.	- Slavic
sluji	x_{1} is a/the muscle [body-part] controlling x_{2}, of body x_{3}; [metaphor: tools of physical power].	- muscle
sluni	x_{1} is a quantity of/contains onions/scallions of type/cultivar x_{2}.	- onion
smacu	x_{1} is a mouse of species/breed x_{2}.	- mouse; animal
smadi	x_{1} guesses/conjectures/surmises x_{2} (du'u) is true about subject x_{3}; [epistemology].	- guess
smaji	x_{1} (source) is quiet/silent/[still] at observation point x_{2} by standard x_{3}.	- quiet
smani	x_{1} is a monkey/ape/simian/baboon/chimpanzee of species/breed x_{2}.	- monkey
smoka	x_{1} is a sock/stocking [flexible foot and lower leg garment] of material x_{2}.	- sock
smuci	x_{1} is a spoon/scoop (tool) for use x_{2}, made of material x_{3}.	- spoon
smuni	x_{1} is a meaning/interpretation of x_{2} recognized/seen/accepted by x_{3}.	- meaning
snada	x_{1} [agent] succeeds in/achieves/completes/accomplishes x_{2} as a result of effort/attempt/try x_{3}.	- succeed
snanu	x_{1} is to the south/southern side of x_{2} according to frame of reference x_{3}.	- south
snidu	x_{1} is x_{2} seconds in duration (default is 1 second) by standard x_{3}.	- second
snime	x_{1} is made of/contains/is a quantity/expanse of snow.	- snow
snipa	x_{1} adheres/sticks to x_{2}; (adjective:) x_{1} is sticky/gummy/adhesive.	- adhere<br>- stick; adhere<br>- sticky
snuji	x_{1} is a sandwich/layering [not restricted to food] of x_{2} sandwiched between x_{3}.	- sandwich
snura	x_{1} is secure/safe from threat x_{2} (event).	- safe; secure<br>- secure
snuti	x_{1} (event/state) is an accident/unintentional on the part of x_{2}; x_{1} is an accident.	- accidental
sobde	x_{1} is a quantity of soya [grain/bean] of species/strain x_{2}.	- soya
sodna	x_{1} is a quantity of/contains/is made of alkali metal of type x_{2} [default sodium].	- sodium
sodva	x_{1} is made of/contains/is a quantity of a carbonated beverage/soda of flavor/brand x_{2}.	- soda
softo	x_{1} reflects Russian empire/USSR/ex-USSR (Soviet]/CIS culture/nationality in aspect x_{2}.	- Soviet
solji	x_{1} is a quantity of/contains/is made of gold (Au); [metaphor: valuable, heavy, non-reactive].	- gold<br>- golden; made of gold (Au)
solri	x_{1} is the sun of home planet x_{2} (default Earth) of race x_{3}; (adjective:) x_{1} is solar.	- solar
sombo	x_{1} sows/plants x_{2} [crop/plants] at/in x_{3}.	- sow<br>- plant; place in soil
sonci	x_{1} is a soldier/warrior/fighter of army x_{2}.	- soldier
sorcu	x_{1} is a store/deposit/supply/reserve of materials/energy x_{2} in containment x_{3}.	- hold; store<br>- stock; supply<br>- store
sorgu	x_{1} is a quantity of sorghum of species/strain x_{2}.	- sorghum
sovda	x_{1} is an egg/ovum/sperm/pollen/gamete of/from organism [mother/father] x_{2}.	- egg
spaji	x_{1} (event/action abstract) surprises/startles/is unexpected [and generally sudden] to x_{2}.	- surprise
spali	x_{1} (agent) polishes object/surface x_{2} with polish x_{3}, applied using tool x_{4}.	- polish
spano	x_{1} reflects Spanish-speaking culture/nationality/language in aspect x_{2}.	- Spanish
spati	x_{1} is a plant/herb/greenery of species/strain/cultivar x_{2}.	- plant
speni	x_{1} is married to x_{2}; x_{1} is a spouse of x_{2} under law/custom/tradition/system/convention x_{3}.	- married<br>- spouse; marriage
spisa	x_{1} [object/substance] is a piece/portion/lump/chunk/particle of x_{2} [substance].	- piece
spita	x_{1} is a hospital treating patient(s) x_{2} for condition/injuries/disease/illness x_{3}.	- hospital
spofu	x_{1} is broken/inoperable/broken down/non-utile/not usable for function x_{2}.	- broken
spoja	x_{1} bursts/explodes/violently breaks up/decomposes/combusts into pieces/energy/fragments x_{2}.	- explode
spuda	x_{1} answers/replies to/responds to person/object/event/situation/stimulus x_{2} with response x_{3}.	- reply
sputu	x_{1} spits/expectorates x_{2} [predominantly liquid] from x_{3} to/onto x_{4}.	- spit
sraji	x_{1} is vertical/upright/erect/plumb/oriented straight up and down in reference frame/gravity x_{2}.	- vertical
sraku	x_{1} [abrasive/cutting/scratching object/implement] scratches/[carves]/erodes/cuts [into] x_{2}.	- scratch
sralo	x_{1} reflects Australian culture/nationality/geography/dialect in aspect x_{2}.	- Australian
srana	x_{1} pertains to/is germane/relevant to/concerns/is related/associated with/is about x_{2}.	- pertain<br>- pertinent; relevant<br>- relevant<br>- relate; pertain
srasu	x_{1} is a blade/expanse of grass of species x_{2}.	- grass
srera	x_{1} errs in doing/being/making mistake x_{2} (event), an error under conditions x_{3} by standard x_{4}.	- err
srito	x_{1} reflects Sanskrit language/Sanskritic/Vedic culture/nationality in aspect x_{2}.	- Sanskrit
sruma	x_{1} assumes/supposes that x_{2} (du'u) is true about subject x_{3}; [epistemology].	- suppose; hypothesize<br>- assume
sruri	x_{1} encircles/encloses/is surrounding x_{2} in direction(s)/dimension(s)/plane x_{3}.	- surround
stace	x_{1} is honest/open/truthfully revealing to/candid/frank with x_{2} about matter/fact x_{3}.	- honest
stagi	x_{1} is the edible x_{2} portion of plant x_{3}; x_{1} is a vegetable.	- vegetable
staku	x_{1} is a quantity of/contains/is made of ceramic made by x_{2}, of composition x_{3}, in form/shape x_{4}.	- ceramic
stali	x_{1} remains/stays at/abides/lasts with x_{2}.	- remain
stani	x_{1} is a/the stalk/stem/trunk [body-part] of plant/species x_{2}; [metaphor: main support].	- stem; body-part<br>- stalk
stapa	x_{1} steps/treads on/in surface x_{2} using limbs x_{3}.	- step
stasu	x_{1} is a quantity of soup/stew/olla/olio [food] of ingredients including x_{2}.	- soup
stati	x_{1} has a talent/aptitude/innate skill for doing/being x_{2}.	- talent
steba	x_{1} feels frustration about x_{2} (abstraction).	- frustration
steci	x_{1} (ka) is specific/particular/specialized/[special]/a defining property of x_{2} among x_{3} (set).	- special; of particular interest/value<br>- particular; specific<br>- specific
stedu	x_{1} is a/the head [body-part] of x_{2}; [metaphor: uppermost portion].	- head
stela	x_{1} is a lock/seal of/on/for sealing x_{2} with/by locking mechanism x_{3}.	- lock
stero	x_{1} is x_{2} steradian(s) [metric unit] in solid angle (default is 1) by standard x_{3}.	- steradian
stici	x_{1} is to the west/western side of x_{2} according to frame of reference x_{3}.	- west<br>- western; pertaining to the west
stidi	x_{1} (agent) suggests/proposes idea/action x_{2} to audience x_{3}; x_{1} (event) inspires x_{2} in/among x_{3}.	- propose<br>- suggest
stika	x_{1} (event) adjusts/regulates/changes x_{2} (ka/ni) in amount/degree x_{3}.	- adjust<br>- edit
stizu	x_{1} is a chair/stool/seat/bench, a piece or portion of a piece of furniture intended for sitting.	- chair
stodi	x_{1} is constant/invariant/unchanging in property x_{2} (ka) in response to stimulus/conditions x_{3}.	- constant
stuna	x_{1} is to the east/eastern side of x_{2} according to frame of reference x_{3}.	- east
stura	x_{1} is a structure/arrangement/organization of x_{2} [set/system/complexity].	- structure
stuzi	x_{1} is an inherent/inalienable site/place/position/situation/spot/location of x_{2} (object/event).	- location<br>- place; location<br>- site
sucta	x_{1} (si'o) is abstracted/generalized/idealized from x_{2} [something concrete] by rules x_{3}.	- abstract
sudga	x_{1} is dry of liquid x_{2}; (adjective:) x_{1} is arid.	- dry
sufti	x_{1} is a/the hoof [body-part] of x_{2}.	- hoof
suksa	x_{1} (event/state) is sudden/sharply changes at stage/point x_{2} in process/property/function x_{3}.	- sudden
sumji	x_{1} is a mathematical sum/result/total of x_{2} plus/increased by x_{3}.	- sum; mathematical gismu<br>- total; sum
sumne	x_{1} (experiencer) smells/scents (transitive verb) x_{2}; x_{2} smells/has odor/scent to observer x_{1}.	- smell
sumti	x_{1} is a/the argument of predicate/function x_{2} filling place x_{3} (kind/number).	- argument
sunga	x_{1} is a quantity of garlic [bulb] of species/strain x_{2}.	- garlic
sunla	x_{1} is a quantity of/made from/consists of wool [tight curly hair] from animal/species/source x_{2}.	- wool
surla	x_{1} relaxes/rests/is at ease in/by doing/being x_{2} (activity).	- relax; to be at ease<br>- rest; take repose
sutra	x_{1} is fast/swift/quick/hastes/rapid at doing/being/bringing about x_{2} (event/state).	- quick; fast<br>- fast<br>- rapid
tabno	x_{1} is a quantity of/contains/is made of carbon/graphite/[diamond]/charcoal; x_{1} is organic.	- carbon
tabra	x_{1} is a horn/trumpet/trombone/bugle [brass-wind/lip-reed musical instrument].	- trumpet
tadji	x_{1} [process] is a method/technique/approach/means for doing x_{2} (event) under conditions x_{3}.	- way; method<br>- method
tadni	x_{1} studies/is a student of x_{2}; x_{1} is a scholar; (adjective:) x_{1} is scholarly.	- study
tagji	x_{1} is snug/tight on x_{2} in dimension/direction x_{3} at locus x_{4}.	- snug
talsa	x_{1} (person) challenges x_{2} at/in property x_{3}.	- challenge
tamca	x_{1} is a tomato [fruit/vegetable/plant] of species/strain x_{2}.	- tomato; fruit or plant
tamji	x_{1} is a/the thumb/big toe [body-part] on limb x_{2} of x_{3}; [metaphor based on relative shape].	- thumb
tamne	x_{1} is cousin to x_{2} by bond/tie x_{3}; [non-immediate family member, default same generation].	- cousin
tanbo	x_{1} is a board/plank [3-dimensional long flat rectangle] of material x_{2}.	- board
tance	x_{1} is a/the tongue [body-part] of x_{2}; (metaphor: similar to nazbi, tamji, degji).	- tongue
tanjo	x_{1} is the trigonometric tangent of angle/arctangent x_{2}.	- tangent
tanko	x_{1} is a quantity of tobacco [leaf] of species/strain x_{2}.	- tobacco
tanru	x_{1} is a binary metaphor formed with x_{2} modifying x_{3}, giving meaning x_{4} in usage/instance x_{5}.	- phrase compound<br>- binary metaphor; phrase compound
tansi	x_{1} is a pan/basin/tub/sink, a shallow container for contents x_{2}, of material/properties x_{3}.	- pan
tanxe	x_{1} is a box/carton/trunk/crate for contents x_{2}, and made of material x_{3}.	- box
tapla	x_{1} is a tile/cake [shape/form] of material x_{2}, shape x_{3}, thickness x_{4}.	- tile
tarbi	x_{1} is an embryo/zygote/fetus/fertilized egg with mother x_{2}, and father x_{3}.	- embryo
tarci	x_{1} is a star/sun with stellar properties x_{2}.	- star; celestial body
tarla	x_{1} is a quantity of/contains/is made of tar/asphalt from source x_{2}.	- tar
tarmi	x_{1} [ideal] is the conceptual shape/form of object/abstraction/manifestation x_{2} (object/abstract).	- shape
tarti	x_{1} behaves/conducts oneself as/in-manner x_{2} (event/property) under conditions x_{3}.	- behave
taske	x_{1} thirsts for x_{2}; x_{1} needs/wants drink/fluid/lubrication x_{2}.	- thirst
tatpi	x_{1} is tired/fatigued by effort/situation x_{2} (event); x_{1} needs/wants rest.	- tired
tatru	x_{1} is a/the breast/mammary/teat [body-part] of x_{2}; [metaphor: projection providing liquid].	- breast
tavla	x_{1} talks/speaks to x_{2} about subject x_{3} in language x_{4}.	- talk; any speech
taxfu	x_{1} is dress/a garment/clothing for wearing by x_{2} (gender/species/body part) serving purpose x_{3}.	- garment
tcaci	x_{1} is a custom/habit/[ritual/rut] of x_{2} under conditions x_{3}.	- custom; habit
tcadu	x_{1} is a town/city of metropolitan area x_{2}, in political unit x_{3}, serving hinterland/region x_{4}.	- city
tcana	x_{1} is a station/node of/in/on transport/communication/distribution system/network x_{2}.	- station
tcati	x_{1} is made of/contains/is a quantity of tea brewed from leaves x_{2}.	- tea
tcena	x_{1} stretches/extends to range x_{2} [interval/extent] in dimension x_{3} from relaxed range x_{4}.	- extend; increase in extent<br>- stretch
tcica	x_{1} (event/experience) misleads/deceives/dupes/fools/cheats/tricks x_{2} into x_{3} (event/state).	- deceive
tcidu	x_{1} [agent] reads x_{2} [text] from surface/document/reading material x_{3}; x_{1} is a reader.	- read
tcika	x_{1} [hours, minutes, seconds] is the time/hour of state/event x_{2} on day x_{3} at location x_{4}.	- time of day
tcila	x_{1} is a detail/feature/particular of x_{2}.	- detail
tcima	x_{1} is weather at place/region x_{2}; (adjective:) x_{1} is meteorological.	- weather
tcini	x_{1} [state/property] is a situation/condition/state/position/are conditions/circumstances of x_{2}.	- situation<br>- condition; particular state of being
tcita	x_{1} is a label/tag of x_{2} showing information x_{3}.	- label
temci	x_{1} is the time-duration/interval/period/[elapsed time] from time/event x_{2} to time/event x_{3}.	- time
tenfa	x_{1} is the exponential result of base x_{2} to power/exponent x_{3}.	- exponential
tengu	x_{1} (property-ka) is a texture of x_{2}.	- texture
terdi	x_{1} is the Earth/the home planet of race x_{2}; (adjective:) x_{1} is terrestrial/earthbound.	- earth
terpa	x_{1} fears x_{2}; x_{1} is afraid/scared/frightened by/fearful of x_{2} (event/tu'a object).	- fear
terto	x_{1} is a trillion [10^{12}] of x_{2} in dimension/aspect x_{3} (default is units).	- trillion<br>- 1E12
tigni	x_{1} performs x_{2} [performance] for/before audience x_{3}.	- perform
tikpa	x_{1} kicks [hits with x_{1}'s foot/feet x_{4}] x_{2} in/at locus x_{3}, using x_{1}'s foot/feet x_{4}.	- kick; to strike with the foot or feet
tilju	x_{1} is heavy/weighty in mass/weight by standard x_{2}.	- heavy
tinbe	x_{1} obeys/follows the command/rule x_{2} made by x_{3}; (adjective:) x_{1} is obedient.	- obey
tinci	x_{1} is a quantity of/contains/is made of tin (Sn); [metaphor: cheap or base metal].	- tin
tinsa	x_{1} is stiff/rigid/inflexible/resistant in direction x_{2} against force x_{3} under conditions x_{4}.	- stiff
tirna	x_{1} hears x_{2} against background/noise x_{3}; x_{2} is audible; (adjective:) x_{1} is aural.	- hear
tirse	x_{1} is a quantity of/contains/is made of iron (Fe); [metaphor: strong, durable, tarnishing].	- iron; metal
tirxu	x_{1} is a tiger/leopard/jaguar/[tigress] of species/breed x_{2} with coat markings x_{3}.	undefined
tisna	x_{1} (object) fills/becomes stuffed [up]/inflates/blows up with material x_{2}; x_{2} pours into x_{1}.	- fill
titla	x_{1} is sweet/sugary/saccharine to observer x_{2}.	- sweet
tivni	x_{1} broadcasts/televises programming x_{2} via medium/channel x_{3} to television receiver x_{4}.	- television
tixnu	x_{1} is a daughter of mother/father/parents x_{2}; [not necessarily biological].	- daughter
toknu	x_{1} is an oven [enclosure that heats its contents] for baking/heating/drying x_{2}.	- oven
toldi	x_{1} is a butterfly/moth of species/breed x_{2}.	- butterfly
tonga	x_{1} is a tone/note of frequency/pitch x_{2} from source x_{3}.	- tone
tordu	x_{1} is short in dimension/direction x_{2} (default longest dimension) by measurement standard x_{3}.	- short
torni	x_{1} twists under load/force/torsion x_{2}.	- twist
traji	x_{1} is superlative in property x_{2} (ka), the x_{3} extreme (ka; default ka zmadu) among set/range x_{4}.	- least; superlative<br>- superlative<br>- best; superlative
trano	x_{1} is a quantity of/contains/is made of nitrogen/ammonia/nitrates.	- nitrogen
trati	x_{1} is taut/tense/strained tight in direction x_{2}.	- taut
trene	x_{1} is a train [vehicle] of cars/units x_{2} (mass) for rails/system/railroad x_{3}, propelled by x_{4}.	- train
tricu	x_{1} is a tree of species/cultivar x_{2}.	- tree; plant
trina	x_{1} attracts/appeals to/lures x_{2} (person/event) with property/quality x_{3} (ka).	- attract
trixe	x_{1} is posterior/behind/back/in the rear of x_{2} which faces/in-frame-of-reference x_{3}.	- behind<br>- back; behind
troci	x_{1} tries/attempts/makes an effort to do/attain x_{2} (event/state/property) by actions/method x_{3}.	- attempt; to try<br>- try
tsali	x_{1} is strong/powerful/[tough] in property/quality x_{2} (ka) by standard x_{3}.	- strong
tsani	x_{1} is an expanse of sky/the heavens at place x_{2}; [celestial].	- sky
tsapi	x_{1} is a seasoning/condiment/spice causing flavor/effect x_{2} (event/property).	- seasoning
tsiju	x_{1}(s) is/are (a) seed(s)/spore(s) [body-part] of organism x_{2} for producing offspring x_{3}.	- seed
tsina	x_{1} is a stage/platform/dais/[scaffold] at/in x_{2} supporting x_{3}, made of material x_{4}.	- stage
tubnu	x_{1} is a length of tubing/pipe/hollow cylinder [shape/form] of material x_{2}, hollow of material x_{3}.	- tube
tugni	x_{1} [person] agrees with person(s)/position/side x_{2} that x_{3} (du'u) is true about matter x_{4}.	- agree
tujli	x_{1} is a tulip (defined by flower shape) of species/strain x_{2}.	- tulip
tumla	x_{1} is a parcel/expanse of land at location x_{2}; x_{1} is terrain.	- land
tunba	x_{1} is a sibling of x_{2} by bond/tie/standard/parent(s) x_{3}.	- sibling
tunka	x_{1} is made of/contains/is a quantity of copper (Cu); [metaphor: reddish, electrical conductor].	- copper
tunlo	x_{1} gulps/swallows.	- swallow
tunta	x_{1} (object, usually pointed) pokes/jabs/stabs/prods x_{2} (experiencer).	- poke
tuple	x_{1} is a/the leg [body-part] of x_{2}; [metaphor: supporting branch].	- leg
turni	x_{1} governs/rules/is ruler/governor/sovereign/reigns over people/territory/domain/subjects x_{2}.	- govern
tutci	x_{1} is a tool/utensil/resource/instrument/implement used for doing x_{2}; [form determines function].	- tool<br>- instrument; tool
tutra	x_{1} is territory/domain/space of/belonging to/controlled by x_{2}.	- territory
vacri	x_{1} is a quantity of air/normally-gaseous atmosphere of planet x_{2}, of composition including x_{3}.	- air
vajni	x_{1} (object/event) is important/significant to x_{2} (person/event) in aspect/for reason x_{3} (nu/ka).	- important
valsi	x_{1} is a word meaning/causing x_{2} in language x_{3}; (adjective: x_{1} is lexical/verbal).	- word
vamji	x_{1} (ni) is the equivalent value/worth of x_{2} [item(s) of value] to x_{3} for use/appreciation x_{4}.	- value; monetary worth<br>- worth; equal in value to
vamtu	x_{1} vomits/regurgitates x_{2}; x_{1} throws x_{2} up; [violent] digestive expulsion.	- vomit
vanbi	x_{1} (ind./mass) is part of an environment/surroundings/context/ambience of x_{2}.	- environment
vanci	x_{1} is an evening [from end-of-work until sleep typical for locale] of day x_{2} at location x_{3}.	- evening
vanju	x_{1} is made of/contains/is a quantity of wine from fruit/grapes x_{2}.	- wine
vasru	x_{1} contains/holds/encloses/includes contents x_{2} within; x_{1} is a vessel containing x_{2}.	- include; enclose<br>- contain
vasxu	x_{1} breathes/respires x_{2} [gas].	- breathe
vecnu	x_{1} [seller] sells/vends x_{2} [goods/service/commodity] to buyer x_{3} for amount/cost/expense x_{4}.	- sell
venfu	x_{1} takes revenge on/retaliates against x_{2} (person) for wrong x_{3} (nu) with vengeance x_{4} (nu).	- revenge
vensa	x_{1} is spring/springtime [warming season] of year x_{2} at location x_{3}; (adjective:) x_{1} is vernal.	- spring
verba	x_{1} is a child/kid/juvenile [a young person] of age x_{2}, immature by standard x_{3}.	- juvenile; human<br>- kid; humanoid<br>- child
vibna	x_{1} is a/the vagina [body-part] of x_{2}.	- vagina
vidni	x_{1} is a video monitor/CRT/screen [machine] serving function x_{2}.	- video; monitor
vidru	x_{1} is a virus of species/breed/defining property x_{2} capable of infecting [at] x_{3}.	- virus
vifne	(adjective:) x_{1} is fresh/unspoiled.	- fresh
vikmi	x_{1} [body] excretes waste x_{2} from source x_{3} via means/route x_{4}.	- excrete
viknu	x_{1} is thick/viscous under conditions x_{2}.	- viscous
vimcu	x_{1} removes/subtracts/deducts/takes away x_{2} from x_{3} with/leaving result/remnant/remainder x_{4}.	- delete<br>- remove<br>- erase
vindu	x_{1} is poisonous/venomous/toxic/a toxin to x_{2}.	- poison
vinji	x_{1} is an airplane/aircraft [flying vehicle] for carrying passengers/cargo x_{2}, propelled by x_{3}.	- airplane
vipsi	x_{1} is a deputy/vice/subordinate in aspect [or organization principle] x_{2} (ka) to principal x_{3}.	- deputy
virnu	x_{1} is brave/valiant/courageous in activity x_{2} (event) by standard x_{3}.	- brave
viska	x_{1} sees/views/perceives visually x_{2} under conditions x_{3}.	- see; perceive visually, not implying mental processing
vitci	x_{1} is irregular/occasional/intermittent in property/action/aspect x_{2}.	- irregular
vitke	x_{1} is a guest/visitor of x_{2} at place/event x_{3}; x_{1} visits x_{2}/x_{3}.	- visit<br>- guest<br>- visitor<br>- attend; be at an event
vitno	x_{1} is permanent/lasting/[eternal] in property x_{2} (ka) by standard x_{3} [time-span/expectant one].	- permanent
vlagi	x_{1} is a/the vulva [body-part] of x_{2}.	- vulva
vlile	x_{1} is an event/state/act of violence.	- violent
vlina	x_{1} is a logical alternation/disjunction, stating that x_{2} (du'u) and/or x_{3} (du'u) is/are true.	- alternation
vlipa	x_{1} has the power to bring about x_{2} under conditions x_{3}; x_{1} is powerful in aspect x_{2} under x_{3}.	- powerful
vofli	x_{1} flies [in air/atmosphere] using lifting/propulsion means x_{2}.	- flight
voksa	x_{1} is a voice/speech sound of individual x_{2}.	- voice
vorme	x_{1} is a doorway/gateway/access way between x_{2} and x_{3} of structure x_{4}.	- door
vraga	x_{1} is a lever [tool] [of apparatus] for doing x_{2} [function/action], with fulcrum x_{3} and arm x_{4}.	- lever
vreji	x_{1} is a record of x_{2} (data/facts/du'u) about x_{3} (object/event) preserved in medium x_{4}.	- record
vreta	x_{1} lies/rests/reclines/reposes on x_{2}; x_{1} is reclining/recumbent/lying on x_{2}.	- reclining
vrici	x_{1} (set/mass/ind.) is miscellaneous/various/assorted in property x_{2} (ka).	- miscellaneous<br>- diverse<br>- assorted
vrude	x_{1} is virtuous/saintly/[fine/moral/nice/holy/morally good] by standard x_{2}.	- virtue<br>- virtuous
vrusi	x_{1} (ka) is a taste/flavor of/emitted by x_{2}; x_{2} tastes of/like x_{1}.	- taste
vukro	x_{1} reflects Ukrainian language/culture/nationality in aspect x_{2}.	- Ukrainian
xabju	x_{1} dwells/lives/resides/abides at/inhabits/is a resident of location/habitat/nest/home/abode x_{2}.	- dwell
xadba	x_{1} is exactly/approximately half/semi-/demi-/hemi- of x_{2} by standard x_{3}.	- half
xadni	x_{1} is a/the body/corpus/corpse of x_{2}; (adjective:) x_{1} is corporal/corporeal.	- body
xagji	x_{1} hungers for x_{2}; x_{1} needs/wants food/fuel x_{2}.	- be hungry
xagri	x_{1} is a oboe/clarinet/saxophone [reed musical instrument] with reed x_{2}.	- reed; instrument
xajmi	x_{1} is funny/comical to x_{2} in property/aspect x_{3} (nu/ka); x_{3} is what is funny about x_{1} to x_{2}.	- funny
xaksu	x_{1} (event) uses up/depletes/consumes/[wastes] x_{2} [resource].	- use up<br>- consume; use up<br>- spend; consume
xalbo	x_{1} uses levity/is non-serious/frivolous about x_{2} (abstraction).	- levity
xalka	x_{1} is a quantity of/contains/is made of alcohol of type x_{2} from source/process x_{3}.	- alcohol
xalni	x_{1} (person) is panicked by crisis x_{2} (event/state).	- panic
xamgu	x_{1} (object/event) is good/beneficial/nice/[acceptable] for x_{2} by standard x_{3}.	- beneficial<br>- good<br>- nice<br>- fine; satisfactory<br>- satisfactory<br>- well; satisfactory
xampo	x_{1} is x_{2} ampere(s) [metric unit] in current (default is 1) by standard x_{3}.	- ampere
xamsi	x_{1} is a sea/ocean/gulf/[atmosphere] of planet x_{2}, of fluid x_{3}; (adjective:) x_{1} is marine.	- sea
xance	x_{1} is a/the hand [body-part] of x_{2}; [metaphor: manipulating tool, waldo].	- hand; body part
xanka	x_{1} is nervous/anxious about x_{2} (abstraction) under conditions x_{3}.	- nervous<br>- worry; be anxious about
xanri	x_{1} [concept] exists in the imagination of/is imagined by/is imaginary to x_{2}.	- imaginary
xanto	x_{1} is an elephant of species/breed x_{2}.	- elephant
xarci	x_{1} is a weapon/arms for use against x_{2} by x_{3}.	- weapon<br>- arm; weapon
xarju	x_{1} is a pig/hog/swine/[boar] [pork/ham/bacon-producer] of species/breed x_{2}.	- pig
xarnu	x_{1} is stubborn/willfully opposing/resisting x_{2} about x_{3} (event/state).	- stubborn
xasli	x_{1} is a donkey/jackass of species/breed x_{2}.	- donkey
xasne	x_{1} is a/the sweat/perspiration from body x_{2}, excreted by gland(s)/organs x_{3}.	- sweat
xatra	x_{1} is a letter/missive/[note] to intended audience x_{2} from author/originator x_{3} with content x_{4}.	- letter
xatsi	x_{1} is 10^{-18} of x_{2} in dimension/aspect x_{3} (default is units).	- 1E-18
xazdo	x_{1} reflects Asiatic culture/nationality/geography in aspect x_{2}.	- Asiatic
xebni	x_{1} hates/despises x_{2} (object/abstraction); x_{1} is full of hate for x_{2}; x_{2} is odious to x_{1}.	- hate
xebro	x_{1} reflects Hebrew/Jewish/Israeli culture/nationality/language in aspect x_{2}.	- Hebrew
xecto	x_{1} is a hundred [100; 10^2] of x_{2} in dimension/aspect x_{3} (default is units).	- 100
xedja	x_{1} is a/the jaw [body-part] of x_{2}.	- jaw
xekri	x_{1} is black/extremely dark-colored [color adjective].	- black
xelso	x_{1} reflects Greek/Hellenic culture/nationality/language in aspect x_{2}.	- Greek
xendo	x_{1} (person) is kind to x_{2} in actions/behavior x_{3}.	- kind
xenru	x_{1} regrets/rues (abstraction) x_{2}; x_{1} is regretful/rueful/sorry/[remorseful] about x_{2}.	- regret
xexso	x_{1} is 10^{18} of x_{2} in dimension/aspect x_{3} (default is units).	- 1E18
xindo	x_{1} reflects Hindi language/culture/religion in aspect x_{2}.	- Hindi
xinmo	x_{1} is a quantity of ink of color/pigment x_{2} used by writing device x_{3}.	- ink
xirma	x_{1} is a horse/equine/[colt/mare/stallion/pony] of species/breed x_{2}.	- horse
xislu	x_{1} is a wheel [tool] of device/vehicle x_{2}, made of materials/having properties x_{3}.	- wheel
xispo	x_{1} reflects Hispano-American culture/nationalities in aspect x_{2}.	- Latino; Hispanic<br>- Hispanic
xlali	x_{1} is bad for x_{2} by standard x_{3}; x_{1} is poor/unacceptable to x_{2}.	- bad
xlura	x_{1} (agent) influences/lures/tempts x_{2} into action/state x_{3} by influence/threat/lure x_{4}.	- influence<br>- lead; draw/direct by influence
xotli	x_{1} is a hotel/inn/hostel at location x_{2} operated by x_{3}.	- hotel
xrabo	x_{1} reflects Arabic-speaking culture/nationality in aspect x_{2}.	- Arabic
xrani	x_{1} (event) injures/harms/damages victim x_{2} in property x_{3} (ka) resulting in injury x_{4} (state).	- injure
xriso	x_{1} pertains to the Christian religion/culture/nationality in aspect x_{2}.	- Christian
xruba	x_{1} is a quantity of buckwheat/rhubarb/sorrel grass of species/strain x_{2}.	- buckwheat
xruki	x_{1} is a turkey [food/bird] of species/breed x_{2}.	- turkey; bird
xrula	x_{1} is a/the flower/blossom/bloom [body-part] of plant/species x_{2}; (adjective:) x_{1} is floral.	- flower
xruti	x_{1} (agent) returns x_{2} to origin/earlier state x_{3} from x_{4}; x_{1} moves/gives x_{2} back to x_{3} from x_{4}.	- return; to an earlier state<br>- undo
xukmi	x_{1} is an instance of substance/chemical/drug x_{2} (individual or mass) with purity x_{3}.	- chemical
xunre	x_{1} is red/crimson/ruddy [color adjective].	- red
xurdo	x_{1} reflects Urdu language/culture/nationality in aspect x_{2}.	- Urdu
xusra	x_{1} (agent) asserts/claims/declares x_{2} (du'u) is true [can be used for epistemology of authority].	- declare; claim<br>- assert<br>- claim; state a fact
xutla	x_{1} is smooth/even/[soft/silky] in texture/regularity.	- smooth
zabna	x_1 is favorable/great/superb/fabulous/dandy/outstanding/swell/admirable/nice/commendable/delightful/desirable/enjoyable/laudable/likable/lovable/wonderful/praiseworthy/high-quality/cool in property x_2 by standard x_3; x_1 rocks in aspect x_2 according to x_3	- favorable
zajba	x_{1} is a gymnast at/performs gymnastics feat x_{2}.	- gymnast
zalvi	x_{1} [individual or mass of hard surfaces] grinds/pulverizes/crushes x_{2} into powder x_{3}.	- grind
zanru	x_{1} approves of/gives favor to plan/action x_{2} (object/event).	- approve
zarci	x_{1} is a market/store/exchange/shop(s) selling/trading (for) x_{2}, operated by/with participants x_{3}.	- market<br>- shop; store
zargu	x_{1} is a/the buttock(s)/arse/rear/seat [body-part] of x_{2}; [metaphor: rounded surface, support].	- behind; body part<br>- rear; body part<br>- arse; body part<br>- buttock<br>- butt; body part<br>- ass; body part
zasni	x_{1} is temporary/not permanent/expected to change in property x_{2} (ka) by standard/expectant x_{3}.	- temporary
zasti	x_{1} exists/is real/actual/reality for x_{2} under metaphysics x_{3}.	- exist
zbabu	x_{1} is a quantity of/contains/is made of soap from source x_{2} of composition including x_{3}.	- soap
zbani	x_{1} is a bay in/of coast/shoreline x_{2}.	- bay
zbasu	x_{1} makes/assembles/builds/manufactures/creates x_{2} out of materials/parts/components x_{3}.	- build; form by combining materials<br>- make<br>- manufacture
zbepi	x_{1} is a pedestal/base/stand/pallet supporting x_{2} (object/event), of materials/properties x_{3}.	- pedestal
zdani	x_{1} is a nest/house/lair/den/[home] of/for x_{2}.	- nest
zdile	x_{1} (abstract) is amusing/entertaining to x_{2} in property/aspect x_{3}; x_{3} is what amuses x_{2} about x_{1}.	- amusing
zekri	x_{1} (event/state) is a punishable crime/[taboo/sin] to people/culture/judges/jury x_{2}.	- crime
zenba	x_{1} (experiencer) increases/is incremented/augmented in property/quantity x_{2} by amount x_{3}.	- increase
zepti	x_{1} is 10^{-21} of x_{2} in dimension/aspect x_{3} (default is units).	- 1E-21
zetro	x_{1} is 10^{21} of x_{2} in dimension/aspect x_{3} (default is units).	- zetta; prefix<br>- 1E21
zgana	x_{1} observes/[notices]/watches/beholds x_{2} using senses/means x_{3} under conditions x_{4}.	- observe
zgike	x_{1} is music performed/produced by x_{2} (event).	- music
zifre	x_{1} is free/at liberty to do/be x_{2} (event/state) under conditions x_{3}.	- free; experiencing freedom
zinki	x_{1} is a quantity of/contains/is made of zinc (Zn); [metaphor: hard metal].	- zinc
zirpu	x_{1} is purple/violet [color adjective].	- purple
zivle	x_{1} (agent) invests resources x_{2} in investment x_{3} expecting return/profit x_{4} (object(s)/event).	- invest
zmadu	x_{1} exceeds/is more than x_{2} in property/quantity x_{3} (ka/ni) by amount/excess x_{4}.	- more
zmiku	x_{1} is automatic in function x_{2} under conditions x_{3}.	- automatic
zukte	x_{1} is a volitional entity employing means/taking action x_{2} for purpose/goal x_{3}/to end x_{3}.	- act
zumri	x_{1} is a quantity of maize/corn [grain] of species/strain x_{2}.	- maize
zungi	x_{1} feels guilt/remorse about x_{2} (abstraction).	- guilt
zunle	x_{1} is to the left/left-hand side of x_{2} which faces/in-frame-of-reference x_{3}.	- left
zunti	x_{1} (evt./state) interferes with/hinders/disrupts x_{2} (evt./state/process) due to quality x_{3} (ka).	- interfere
zutse	x_{1} sits [assumes sitting position] on surface x_{2}.	- sit
zvati	x_{1} (object/event) is at/attending/present at x_{2} (event/location).	- at
